STATE NAME,PC NO.,PC NAME,ELECTORS,MALE,FEMALE,THIRD GENDER,TOTAL,NRI,POSTAL VOTES,TOTAL VOTERS,VOTER TURN OUT %,MALE_TURNOUT,FEMALE_TURNOUT,THIRD GENDER_TURNOUT
Andaman & Nicobar Islands,1,Andaman & Nicobar Islands,318471,109407,97671,2,207080,0,318,207398,65.1230410304235,64.63308009499391,65.46840228436604,22.22222222222222
Andhra Pradesh,1,Aruku ,1451418,523085,544258,19,1067362,0,10873,1078235,74.28838556501297,73.70529436464524,73.38712504685651,20.212765957446805
Andhra Pradesh,2,Srikakulam,1553860,548060,594937,14,1143011,0,21275,1164286,74.92862934884738,70.07911167827491,77.10512809878796,6.698564593301436
Andhra Pradesh,3,Vizianagaram,1503980,603059,605843,7,1208909,0,13524,1222433,81.27987074296202,79.97960255485295,80.79619546010422,5.691056910569105
Andhra Pradesh,4,Visakhapatnam,1829300,608306,624713,7,1233026,0,6895,1239921,67.78117312633248,66.25553712419169,68.56968178929448,6.0344827586206895
Andhra Pradesh,5,Anakapalli,1521363,606111,626764,6,1232881,0,7575,1240456,81.53583332840354,80.78916290563795,81.28612726133798,9.090909090909092
Andhra Pradesh,6,Kakinada,1563930,616003,611330,66,1227399,0,9415,1236814,79.08371858075489,79.37886341876398,77.61186071430384,29.333333333333332
Andhra Pradesh,7,Amalapuram ,1459556,617210,607337,0,1224547,0,10821,1235368,84.63998640682509,84.62396963896917,83.17736530210047,0.0
Andhra Pradesh,8,Rajahmundry,1534256,617706,626974,8,1244688,0,5800,1250488,81.50452075794391,81.9227861699447,80.36850551963533,6.557377049180328
Andhra Pradesh,9,Narsapuram,1439691,580912,587960,35,1168907,5,10255,1179162,81.90382519582326,81.94000124127581,80.47742235727289,22.875816993464053
Andhra Pradesh,10,Eluru ,1594950,659879,662137,32,1322048,0,10162,1332210,83.52675632464968,83.99874233370927,81.82248441740111,24.242424242424242
Andhra Pradesh,11,Machilipatnam ,1473347,609214,626244,14,1235472,0,10080,1245552,84.53894432200968,84.43363408312891,83.30858994620309,13.861386138613863
Andhra Pradesh,12,Vijayawada,1652994,632378,640718,36,1273132,0,4643,1277775,77.30064355950475,77.57249981293141,76.49350354758951,20.689655172413794
Andhra Pradesh,13,Guntur,1706119,659306,686873,31,1346210,0,5317,1351527,79.2164555930741,79.42555834105335,78.42690163311119,14.553990610328638
Andhra Pradesh,14,Narasaraopet,1670391,707594,721882,49,1429525,0,11207,1440732,86.25118310623083,86.15232142052697,85.0417503086507,23.78640776699029
Andhra Pradesh,15,Bapatla ,1468671,618167,636396,7,1254570,0,15428,1269998,86.4726000581478,85.54062151028356,85.31612342762763,8.235294117647058
Andhra Pradesh,16,Ongole ,1556469,663664,659603,29,1323296,0,20707,1344003,86.34948720469215,84.94627371924098,85.09831545838188,33.33333333333333
Andhra Pradesh,17,Nandyal,1603220,639159,649242,75,1288476,0,11309,1299785,81.07340227791569,80.67327122573936,80.0935104027239,22.45508982035928
Andhra Pradesh,18,Kurnool,1573009,596807,585326,24,1182157,0,8515,1190672,75.69390893504105,75.85947857388904,74.46109380307169,12.060301507537687
Andhra Pradesh,19,Anantapur,1664160,672882,661447,46,1334375,0,13739,1348114,81.00867705028362,80.8206475914106,79.55668401858998,25.274725274725274
Andhra Pradesh,20,Hindupur,1578218,672703,654120,20,1326843,0,13184,1340027,84.90759831658238,84.57024252077788,83.5712889464667,27.77777777777778
Andhra Pradesh,21,Kadapa,1570330,593730,625851,67,1219648,0,15899,1235547,78.68072316010011,76.65057649630192,78.67361908126054,28.63247863247863
Andhra Pradesh,22,Nellore,1672845,629756,644145,33,1273934,0,15227,1289161,77.06398381200889,76.62514327153089,75.71531338378318,14.163090128755366
Andhra Pradesh,23,Tirupati ,1650453,643590,660641,31,1304262,0,12211,1316473,79.76434348630346,79.39899602382006,78.68323922341152,12.156862745098039
Andhra Pradesh,24,Rajampet,1546938,597375,615378,21,1212774,0,13378,1226152,79.26316374670478,77.86877766712377,78.93296871172019,13.043478260869565
Andhra Pradesh,25,Chittoor ,1566499,650995,658150,27,1309172,0,10463,1319635,84.24103685990224,83.49279596563815,83.6654399379644,17.763157894736842
Arunachal Pradesh,1,ARUNACHAL WEST,463775,160826,183297,0,344123,0,19924,364047,78.49646919303541,71.2338111014652,77.01457544652799,0.0
Arunachal Pradesh,2,ARUNACHAL EAST,339788,139963,142891,0,282854,0,12865,295719,87.03044251121287,80.45006466446328,86.17599343839144,0.0
Assam,1,Karimganj ,1340173,556550,502069,0,1058619,0,2541,1061160,79.1808221774353,79.64618233544846,78.27985724464706,0.0
Assam,2,Silchar,1195720,485516,459284,2,944802,0,5888,950690,79.50774428796039,78.5231979479516,79.55228844208571,2.666666666666667
Assam,3,Autonomous District,795945,312945,302927,0,615872,0,1986,617858,77.62571534465322,77.19717601089337,77.56321132746989,0.0
Assam,4,Dhubri,1858566,862010,820604,2,1682616,0,2442,1685058,90.66441546870007,90.61113452864362,90.4532893598306,8.333333333333332
Assam,5,Kokrajhar,1776358,751087,718477,0,1469564,0,10180,1479744,83.3021271613042,82.43584523173205,83.04153249761328,0.0
Assam,6,Barpeta,1685149,750196,702041,1,1452238,0,6570,1458808,86.56848741565287,85.92414765471183,86.45377948431239,6.25
Assam,7,Gauhati,2181319,899023,862213,4,1761240,0,2710,1763950,80.86620984826153,81.47929626890561,79.99267069623747,5.128205128205128
Assam,8,Mangaldoi,1800237,777107,724548,0,1501655,0,4764,1506419,83.6789267190931,83.96119085305574,82.83862116275081,0.0
Assam,9,Tezpur,1499639,598677,587656,2,1186335,0,5550,1191885,79.47812773607514,77.93020767434413,80.34827027041808,6.451612903225806
Assam,10,Nowgong,1794648,761620,728706,3,1490329,0,3295,1493624,83.2265714502231,82.5801275100837,83.53664198532876,6.122448979591836
Assam,11,Kaliabor,1734938,728541,693125,5,1421671,0,3124,1424795,82.12368395873513,82.16735934495378,81.71360126945653,10.869565217391305
Assam,12,Jorhat,1365035,535678,518560,1,1054239,0,4581,1058820,77.56724186559319,77.22642385308933,77.23769776371722,14.285714285714285
Assam,13,Dibrugarh,1314319,514418,499258,1,1013677,0,2315,1015992,77.30178137879768,77.39193491120699,76.85633752515014,3.571428571428571
Assam,14,Lakhimpur,1708013,651081,628945,2,1280028,0,3922,1283950,75.17214447431022,74.82433982343193,75.0687792796825,4.761904761904762
Bihar,1,Valmiki Nagar,1665502,530289,499397,2,1029688,0,2543,1032231,61.97716964614873,59.261357731236394,64.80835739545144,2.083333333333333
Bihar,2,Paschim Champaran,1633824,524330,483548,5,1007883,0,5490,1013373,62.0246121981315,59.62598011064802,64.09737061172116,7.936507936507936
Bihar,3,Purvi Champaran,1658672,502773,490037,0,992810,0,7325,1000135,60.29733425294452,56.8798569102895,63.25302526703024,0.0
Bihar,4,Sheohar,1686215,500312,500529,0,1000841,0,4086,1004927,59.596611345528295,55.79536317415922,63.401760199428466,0.0
Bihar,5,Sitamarhi,1752454,504721,529645,1,1034367,0,5233,1039600,59.322527153351814,54.34698573599038,64.30095047086489,1.7857142857142856
Bihar,6,Madhubani,1792798,454516,507776,2,962294,0,2412,964706,53.81007787826626,48.037303960269426,59.980108059071036,3.9215686274509802
Bihar,7,Jhanjharpur,1852417,496451,562801,0,1059252,0,3139,1062391,57.351611435222196,51.15082689119615,63.8250507208657,0.0
Bihar,8,Supaul,1690620,529157,580683,0,1109840,0,1156,1110996,65.71529971253149,60.09480578328906,71.68448029390633,0.0
Bihar,9,Araria,1805439,575565,593532,1,1169098,0,643,1169741,64.78983781783822,60.55143450189839,69.43218414738716,1.5873015873015872
Bihar,10,Kishanganj,1659651,537374,563614,3,1100991,0,665,1101656,66.37877481470503,62.55386714284717,70.40484277350215,5.0
Bihar,11,Katihar,1653353,554254,562770,0,1117024,0,1265,1118289,67.63764301997213,63.26421594029864,72.41161015051816,0.0
Bihar,12,Purnia,1765312,574694,578456,1,1153151,0,838,1153989,65.37025749555886,62.72404406773001,68.13091553243915,2.0
Bihar,13,Madhepura,1884883,552934,592789,0,1145723,0,1929,1147652,60.887174429394285,56.59381262653246,65.29735743476202,0.0
Bihar,14,Darbhanga,1654811,468623,493457,2,962082,0,3428,965510,58.345635846027136,53.48246669207891,63.379751647888696,9.523809523809524
Bihar,15,Muzaffarpur,1730553,532392,521572,0,1053964,0,4543,1058507,61.165823872484694,57.70361314153421,64.55985908955314,0.0
Bihar,16,Vaishali,1735983,536923,535176,2,1072101,0,2650,1074751,61.910226079402854,57.584061191571145,66.6040255426443,4.166666666666666
Bihar,17,Gopalganj (SC),1839514,476256,539136,2,1015394,0,10662,1026056,55.77864588146652,50.62454757371957,59.9919882494325,2.73972602739726
Bihar,18,Siwan,1799551,471597,510554,0,982151,0,2699,984850,54.72754036979224,49.96027306704635,59.67525135759987,0.0
Bihar,19,Maharajganj,1807768,467023,501866,2,968891,0,4098,972989,53.82266972310607,48.783043139008115,59.01723010635346,4.081632653061225
Bihar,20,Saran,1667253,479986,458722,0,938708,0,4907,943615,56.59698917920676,53.52804728448757,59.53361729519835,0.0
Bihar,21,Hajipur (SC),1823664,518835,485247,4,1004086,0,3594,1007680,55.255792733749196,52.71754426786184,57.807001450991514,6.779661016949152
Bihar,22,Ujiarpur,1612300,478018,488760,1,966779,0,3083,969862,60.15394157414873,55.522284737289596,65.05584372541739,1.694915254237288
Bihar,23,Samastipur (SC),1679030,496337,520796,0,1017133,0,2638,1019771,60.73572241115406,55.676117701958105,66.13080998166406,0.0
Bihar,24,Begusarai,1958382,603585,613828,3,1217416,0,9087,1226503,62.62838404356249,57.84352152750558,67.0966867466587,4.838709677419355
Bihar,25,Khagaria,1676454,467181,497927,4,965112,0,2299,967411,57.705788527451396,52.730244259765705,62.99396788607806,11.428571428571429
Bihar,26,Bhagalpur,1823820,546334,493759,3,1040096,0,3086,1043182,57.1976401179941,56.512730864912676,57.614415768384355,4.3478260869565215
Bihar,27,Banka,1699394,497999,496121,0,994120,0,1740,995860,58.60088949354888,55.11948112320003,62.33576458910521,0.0
Bihar,28,Munger,1888025,547935,483085,1,1031021,0,5420,1036441,54.895512506455155,53.96625133331167,55.35883517085451,1.8867924528301887
Bihar,29,Nalanda,2114809,559964,469057,0,1029021,0,2853,1031874,48.79277513950432,49.86047074872091,47.299611161755095,0.0
Bihar,30,Patna Sahib,2146008,548683,429918,1,978602,0,4337,982939,45.803137732944144,48.39865781520966,42.472656716948734,0.9009009009009009
Bihar,31,Pataliputra,1925479,595000,478175,0,1073175,0,5634,1078809,56.02808444028733,58.85227189551793,52.29282450695415,0.0
Bihar,32,Arrah,2089353,607717,465201,1,1072919,0,9545,1082464,51.80857423326742,52.85134464078701,49.522395209580836,0.8547008547008548
Bihar,33,Buxar,1829373,543539,436752,0,980291,0,6671,986962,53.950834520898695,55.95511146982039,50.90539507300972,0.0
Bihar,34,Sasaram (SC),1787878,531450,437794,0,969244,0,6333,975577,54.56619523256061,56.58701857911163,51.585528517361155,0.0
Bihar,35,Karakat,1771254,483732,380773,2,864507,0,5039,869546,49.092112142019154,51.60479550405492,45.6661457702451,3.508771929824561
Bihar,36,Jahanabad,1588454,443543,373430,1,816974,0,5259,822233,51.763097955622264,53.44612767023984,49.231268176796455,2.272727272727273
Bihar,37,Aurangabad,1742883,485950,446877,5,932832,0,2637,935469,53.673654513814185,52.80538453012499,54.32725681253153,9.615384615384617
Bihar,38,Gaya (SC),1704596,499260,455841,1,955102,0,2552,957654,56.180702054915066,56.4789089296542,55.5522922094857,1.7241379310344827
Bihar,39,Nawada,1899747,482016,453338,1,935355,0,9336,944691,49.72720051670038,48.75782931684658,49.75858189501413,1.25
Bihar,40,Jamui (SC),1718814,479673,467631,2,947306,0,2255,949561,55.24512832685794,52.612742060205875,57.94152704708614,5.714285714285714
Chandigarh,1,CHANDIGARH,646729,240635,215557,15,456207,1,430,456637,70.60716312396693,70.3197828177007,70.78884886061732,71.42857142857143
Chhattisgarh,1,SARGUJA,1655239,648612,629773,7,1278392,0,2824,1281216,77.4036861142107,78.07256063872428,76.38787978763793,41.17647058823529
Chhattisgarh,2,RAIGARH,1733805,671128,675724,11,1346863,0,3878,1350741,77.90616591831261,77.55343059367327,77.81234958003321,39.285714285714285
Chhattisgarh,3,JANJGIR-CHAMPA,1897134,635661,607315,4,1242980,0,5494,1248474,65.80842470800692,65.80505105716912,65.22322804583234,16.0
Chhattisgarh,4,KORBA,1508840,574105,560913,18,1135036,0,2387,1137423,75.38393732933909,75.61724126576443,74.8323016169486,32.72727272727273
Chhattisgarh,5,BILASPUR,1876953,623184,584177,22,1207383,0,2878,1210261,64.48009087068243,65.34662809243136,63.277199055895615,24.175824175824175
Chhattisgarh,6,RAJNANDGAON,1716459,663568,640925,3,1304496,0,3382,1307878,76.19628549240034,77.235496985971,74.76052835400277,50.0
Chhattisgarh,7,DURG,1940269,715194,674156,11,1389361,0,3358,1392719,71.77968621876657,73.08950882865722,70.10154052522395,16.666666666666664
Chhattisgarh,8,RAIPUR,2111738,721979,671279,33,1393291,0,3851,1397142,66.16076426147562,67.31544356293664,64.61377790183943,11.11111111111111
Chhattisgarh,9,MAHASAMUND,1637951,617513,602242,5,1219760,0,3007,1222767,74.65223318646285,75.8906362143721,73.06625125418415,22.727272727272727
Chhattisgarh,10,BASTAR,1379122,444689,465274,12,909975,0,3786,913761,66.25671985509621,67.03089647562815,65.01218435260846,29.268292682926827
Chhattisgarh,11,KANKER,1558952,577274,577547,8,1154829,0,5414,1160243,74.42454931261514,74.84914100486225,73.32337993908624,25.806451612903224
Dadra & Nagar Haveli,1,Dadra And Nagar Haveli,250029,103446,95479,0,198925,0,59,198984,79.58436821328726,78.133190329086,81.16960953506364,0.0
Daman & Diu,1,Daman & diu,121740,41600,45841,0,87441,0,32,87473,71.85230819779859,68.20007541354492,75.46713201521162,0.0
Goa,1,North Goa,556761,209594,218000,0,427594,1,1412,429006,77.05388847279173,76.96324312415085,76.64424763826729,0.0
Goa,2,South Goa,579352,199877,223780,0,423657,0,1061,424718,73.30914539002195,70.44644713793797,75.69776370580097,0.0
Gujarat,1,Kachchh,1744321,550098,465094,3,1015195,0,8957,1024152,58.713505140395604,60.49679918970726,55.69934659308653,25.0
Gujarat,2,Banaskantha,1697384,614524,482443,3,1096970,0,6769,1103739,65.0258868941854,68.9845467179456,59.814447918707216,75.0
Gujarat,3,Patan,1807043,610449,509917,7,1120373,0,8044,1128417,62.44549797652851,65.03810986978506,58.71778632458948,33.33333333333333
Gujarat,4,Mahesana,1648869,584781,492257,9,1077047,0,7630,1084677,65.78309131895863,68.42953331133407,61.976886632697905,25.0
Gujarat,5,Sabarkantha,1801717,645239,562915,14,1208168,0,12810,1220978,67.76746847590381,69.69769963965054,64.26733310804022,26.41509433962264
Gujarat,6,Gandhinagar,1945772,689408,586038,7,1275453,0,10373,1285826,66.08307653723047,68.64623898850034,62.249504479336835,14.893617021276595
Gujarat,7,Ahmedabad East,1811851,619676,489608,12,1109296,0,9768,1119064,61.76357768933538,64.81878384498955,57.21250194269262,17.91044776119403
Gujarat,8,Ahmedabad West,1643317,544767,446929,6,991702,0,7531,999233,60.8058579081212,63.95014685477225,56.471071351856764,24.0
Gujarat,9,Surendranagar,1849429,598970,470272,9,1069251,0,10948,1080199,58.40716242688959,61.668235047020524,53.554533673150985,27.27272727272727
Gujarat,10,Rajkot,1884339,658951,530759,2,1189712,0,6588,1196300,63.48645333987144,67.23077378274172,58.70007122412596,11.11111111111111
Gujarat,11,Porbandar,1662368,533165,410171,5,943341,0,7766,951107,57.213986313499774,61.61000800797793,51.46636820252732,41.66666666666667
Gujarat,12,Jamnagar,1657166,557825,446952,5,1004782,0,6667,1011449,61.03486313380796,65.02222289570217,55.92191611312204,20.833333333333336
Gujarat,13,Junagadh,1642864,542217,454800,8,997025,0,10227,1007252,61.310735398669635,63.867552601914554,57.288471639813224,50.0
Gujarat,14,Amreli,1628451,495865,411648,6,907519,0,3924,911443,55.96993707517144,58.74259002146584,52.48617234775558,28.57142857142857
Gujarat,15,Bhavnagar,1768297,567578,464533,9,1032120,0,12122,1044242,59.05354134514733,61.618180456204996,54.83538159527163,25.71428571428571
Gujarat,16,Anand,1655870,602173,503504,30,1105707,0,4377,1110084,67.03932071962171,70.45315743043872,62.85565908659656,27.77777777777778
Gujarat,17,Kheda,1804028,612434,481581,23,1094038,0,7135,1101173,61.03968452817805,65.78450433418908,55.16480218468567,31.944444444444443
Gujarat,18,Panchmahal,1744762,577870,498261,6,1076137,0,9581,1085718,62.22728372121814,64.30702495295517,58.886632881711684,40.0
Gujarat,19,Dahod,1598939,543050,514433,3,1057486,0,6905,1064391,66.56858079013645,67.55722864212521,64.70155429727099,18.75
Gujarat,20,Vadodara,1794896,647847,570017,42,1217906,0,5803,1223709,68.17715343953076,70.22023795975039,65.35618056112914,31.57894736842105
Gujarat,21,Chhota Udaipur,1671253,652896,573945,1,1226842,0,8213,1235055,73.89994213922128,75.70581114362973,70.95990504803234,9.090909090909092
Gujarat,22,Bharuch,1564519,606980,538517,13,1145510,0,5148,1150658,73.54707740845589,75.41501367330432,70.89247984202731,31.70731707317073
Gujarat,23,Bardoli,1826526,706293,637358,0,1343651,0,5994,1349645,73.89136535696727,75.55042824456632,71.48129912980869,0.0
Gujarat,24,Surat,1655704,593569,472777,13,1066359,0,2894,1069253,64.57996115247653,66.59280791526476,61.85719294940233,22.033898305084744
Gujarat,25,Navsari,1971658,713388,589682,11,1303081,0,6155,1309236,66.40279399368451,66.26385048305433,65.88669868177888,14.285714285714285
Gujarat,26,Valsad,1671030,647087,609749,2,1256838,0,4526,1261364,75.48422230600288,75.84386936917402,74.55666376876454,14.285714285714285
Haryana,1,Ambala,1853711,707597,605795,2,1313394,0,4528,1317922,71.09641146867014,71.42509619616347,70.19665190029629,6.666666666666667
Haryana,2,Kurukshetra,1657335,654657,572801,4,1227462,0,3703,1231165,74.28582634168711,74.15680317534756,73.95570670312802,26.666666666666668
Haryana,3,Sirsa,1803349,730867,636499,4,1367370,0,2946,1370316,75.98728809564871,76.2089819922213,75.38670538852936,57.14285714285714
Haryana,4,Hisar,1631817,638294,536805,1,1175100,0,6778,1181878,72.42711652103146,72.33432530013985,71.63245208089802,14.285714285714285
Haryana,5,Karnal,1904193,706599,591424,3,1298026,0,3448,1301474,68.34779877880027,69.32695071853473,66.83398970522593,5.88235294117647
Haryana,6,Sonipat,1592611,610957,512815,4,1123776,0,7370,1131146,71.02462559909482,70.5205614801357,70.61301262817857,16.0
Haryana,7,Rohtak,1737133,653164,556508,2,1209674,0,15320,1224994,70.51814685461619,69.65552102684637,69.61492802808074,11.11111111111111
Haryana,8,Bhiwani-Mahendragarh,1654317,608691,538446,3,1147140,0,18766,1165906,70.47657734279464,68.39616652190182,70.44467673967395,20.0
Haryana,9,Gurgaon,2150728,775280,666146,12,1441438,0,6663,1448101,67.33073638321537,67.68627957695202,66.2645245169768,27.906976744186046
Haryana,10,Faridabad,2071816,741280,583185,2,1324467,0,3660,1328127,64.10448611266638,64.86308645669816,62.78022802554764,4.25531914893617
Himachal Pradesh,1,Kangra,1427338,470334,520805,3,991142,0,18414,1009556,70.72998827187394,64.6610318621251,74.40772987167361,15.0
Himachal Pradesh,2,Mandi,1281462,461030,469659,2,930691,0,12457,943148,73.59937321590496,70.84093940343826,74.47091226506792,40.0
Himachal Pradesh,3,Hamirpur,1362269,458194,514168,3,972365,0,19722,992087,72.82607179639264,66.24335136182327,76.67523140450268,42.857142857142854
Himachal Pradesh,4,Shimla,1259085,475787,431773,8,907568,0,7581,915149,72.68365519404965,72.7227289957325,71.3884415580121,53.333333333333336
Jammu & Kashmir,1,Baramulla,1317738,250078,202036,0,452114,0,3885,455999,34.60467862352,36.68866321802993,31.762471623244732,0.0
Jammu & Kashmir,2,Srinagar,1294671,106916,79450,0,186366,0,497,186863,14.433242113247305,16.015146953308378,12.670400540943975,0.0
Jammu & Kashmir,3,Anantnag,1397779,71575,51274,0,122849,0,2616,125465,8.976025537656525,9.877918177853589,7.617047068401006,0.0
Jammu & Kashmir,4,Ladakh,179232,62035,61258,0,123293,0,4057,127350,71.05316014997321,66.67490676153524,71.07321034922845,0.0
Jammu & Kashmir,5,Udhampur,1685816,610575,558519,1,1169095,0,13585,1182680,70.15474998457721,68.11511099558561,70.75359836632522,2.3255813953488373
Jammu & Kashmir,6,Jammu,2047302,758278,697010,2,1455290,0,29097,1484387,72.50454500606163,70.08354259803708,72.20537109091738,8.695652173913043
Jharkhand,1,Rajmahal,1454436,528919,516393,0,1045312,0,2541,1047853,72.04531515996578,71.25321126377291,72.51508879146434,0.0
Jharkhand,2,Dumka,1397253,518137,505399,2,1023538,0,2443,1025981,73.42843422057422,72.06756982307778,74.51119439292569,28.57142857142857
Jharkhand,3,Godda,1716766,610174,578795,0,1188969,0,5374,1194343,69.56935307432695,67.27817214331236,71.47205551851029,0.0
Jharkhand,4,Chatra,1425218,463730,458631,0,922361,0,3595,925956,64.96942923819373,61.75170681754929,68.02040770924947,0.0
Jharkhand,5,Kodarma,1814125,594662,613587,5,1208254,0,1407,1209661,66.6801350513333,61.91029461063879,71.883358111124,31.25
Jharkhand,6,Giridih,1649413,576909,526778,3,1103690,0,3466,1107156,67.1242435945394,65.59056165518935,68.4275680569682,15.789473684210526
Jharkhand,7,Dhanbad,2072634,681732,567412,7,1249151,0,4114,1253265,60.46726050040673,60.55738246627618,59.92704137349789,20.588235294117645
Jharkhand,8,Ranchi,1915959,641669,589258,5,1230932,0,4682,1235614,64.49062845290531,63.96821472506395,64.55499561787906,9.433962264150944
Jharkhand,9,Jamshedpur,1703279,590506,552796,15,1143317,0,1110,1144427,67.18963833875719,67.64736206608181,66.57746249872035,26.785714285714285
Jharkhand,10,Singhbhum,1269917,441917,436562,1,878480,0,1036,879516,69.25775464065762,69.40545107881354,68.94622800035376,14.285714285714285
Jharkhand,11,Khunti,1202664,410870,419556,0,830426,0,2408,832834,69.2491003305994,68.02123066327613,70.0860297679702,0.0
Jharkhand,12,Lohardaga,1234286,404489,409371,0,813860,0,4507,818367,66.30286659655866,63.94122621898687,68.03754130074923,0.0
Jharkhand,13,Palamau,1881441,626122,579847,0,1205969,0,4457,1210426,64.33504957104688,61.63176193119849,66.99305514636646,0.0
Jharkhand,14,Hazaribagh,1667465,552495,526659,1,1079155,0,2227,1081382,64.85185596099468,62.269445994150566,67.50411439294119,8.333333333333332
Karnataka,1,Chikkodi,1612556,632366,579970,9,1212345,0,7138,1219483,75.62422638345583,76.64754415288637,73.64997688794973,15.789473684210526
Karnataka,2,Belgaum,1779350,625609,573504,4,1199117,0,8025,1207142,67.84173996122179,69.69183861937285,65.0514509718517,7.2727272727272725
Karnataka,3,Bagalkot,1704010,619749,580993,14,1200756,0,3946,1204702,70.69805928368964,72.589095278978,68.34078111748522,15.217391304347828
Karnataka,4,Bijapur,1797587,588408,520348,25,1108781,0,3712,1112493,61.888131144695635,63.75704173082195,59.507311645225954,9.293680297397769
Karnataka,5,Gulbarga,1945765,610885,574754,6,1185645,0,4826,1190471,61.182671083095855,62.29909603413532,59.56888903629143,1.7595307917888565
Karnataka,6,Raichur,1928204,575578,546569,5,1122152,0,2810,1124962,58.34247828549262,60.21080865077024,56.237222180494065,1.3623978201634876
Karnataka,7,Bidar,1775095,577170,536980,2,1114152,0,4103,1118255,62.9969100245339,62.75305844644402,62.78676026958389,1.9417475728155338
Karnataka,8,Koppal,1736693,606297,581406,7,1187710,0,2917,1190627,68.55713704149208,70.25246052841977,66.55638918715958,6.1946902654867255
Karnataka,9,Bellary,1751734,621814,597246,17,1219077,0,2908,1221985,69.75859348508392,71.36435053361383,67.85506130003101,7.327586206896551
Karnataka,10,Haveri,1708510,661429,601867,0,1263296,0,4592,1267888,74.21015972982306,75.77999330910558,72.02803730488594,0.0
Karnataka,11,Dharwad,1727311,640913,569597,8,1210518,0,3620,1214138,70.29064250734234,73.04717596159544,67.02647300746403,7.547169811320755
Karnataka,12,Uttara Kannada,1556599,591099,559157,5,1150261,0,4129,1154390,74.16103954840007,74.77514288388896,72.98985086316614,22.727272727272727
Karnataka,13,Davanagere,1633064,617489,574795,9,1192293,0,2932,1195225,73.18910955112598,75.01217830742786,70.98425439950601,6.976744186046512
Karnataka,14,Shimoga,1676668,641691,640582,6,1282279,0,1788,1284067,76.58445202031649,77.13809680083378,75.83140474344329,12.0
Karnataka,15,Udupi Chikmagalur,1513806,563341,585785,5,1149131,11,2492,1151623,76.074675354702,76.22347154851062,75.61570027636968,9.25925925925926
Karnataka,16,Hassan,1652999,644500,629935,3,1274438,0,4215,1278653,77.35352531973703,77.29282046238976,76.90462354354472,6.666666666666667
Karnataka,17,Dakshina Kannada,1724976,653563,689629,21,1343213,5,2134,1345347,77.99221554386844,77.27285625441897,78.4482327139035,20.588235294117645
Karnataka,18,Chitradurga,1760633,639390,603639,6,1243035,0,3471,1246506,70.79874113458058,71.86272812895481,69.32068737425242,5.825242718446602
Karnataka,19,Tumkur,1608545,630450,611065,13,1241528,0,3941,1245469,77.42829700132728,78.45984976329505,75.9187867207194,10.833333333333334
Karnataka,20,Mandya,1712004,695384,680954,28,1376366,0,3256,1379622,80.58520891306328,81.27898713345301,79.52236644653482,19.047619047619047
Karnataka,21,Mysore,1896333,664932,647532,14,1312478,0,5625,1318103,69.5079925308477,70.25485574093699,68.18092797291008,9.333333333333334
Karnataka,22,Chamarajanagar,1686333,646902,620802,11,1267715,0,3010,1270725,75.35433393048704,76.7335270743135,73.6272325002461,9.649122807017543
Karnataka,23,Bangalore Rural,2497458,831105,789254,39,1620398,0,2426,1622824,64.97903067839378,64.53560424405819,65.26573791463277,11.436950146627565
Karnataka,24,Bangalore North,2849250,805444,750147,103,1555694,0,4630,1560324,54.76262174256383,54.348924788139165,54.884775532332874,20.766129032258064
Karnataka,25,Bangalore central,2204817,621875,572763,67,1194705,0,2982,1197687,54.321379053227545,54.25664363058631,54.12375371723237,16.876574307304786
Karnataka,26,Bangalore South,2215489,616311,568793,33,1185137,0,4520,1189657,53.69726502817211,53.42779617525183,53.57859090716415,9.593023255813954
Karnataka,27,Chikkballapur,1808780,706576,678457,36,1385069,0,2918,1387987,76.73608730746692,77.5744480894475,75.57674784394891,15.126050420168067
Karnataka,28,Kolar,1629961,642572,613779,20,1256371,0,2722,1259093,77.24681756189258,78.58938984775547,75.5726318718595,12.658227848101266
Kerala,1,Kasaragod,1363937,507542,588600,1,1096143,204,3956,1100099,80.65614467530392,76.96397322633572,83.5508693634037,50.0
Kerala,2,Kannur,1266550,484899,563025,1,1047925,186,6821,1054746,83.2770913110418,80.60558206027562,84.6685965637806,20.0
Kerala,3,Vadakara,1288926,485642,575195,1,1060838,21477,5094,1065932,82.69923952189653,78.37789856943655,85.94081507025334,5.555555555555555
Kerala,4,Wayanad,1359679,529074,560841,0,1089915,57,2844,1092759,80.36889589381023,78.40375099843364,81.89002016438131,0.0
Kerala,5,Kozhikode,1318024,513589,557937,7,1071533,2693,5349,1076882,81.70427852603595,80.03643481160803,82.49661770033194,46.666666666666664
Kerala,6,Malappuram,1370544,496309,536688,0,1032997,63,1802,1034799,75.50279305151822,71.81487349785486,78.98905873314436,0.0
Kerala,7,Ponnani,1356803,466412,549928,1,1016341,104,1025,1017366,74.9825877448679,69.29023900357733,80.4377556975671,16.666666666666664
Kerala,8,Palakkad,1323010,494469,531513,1,1025983,12,2891,1028874,77.76766615520668,76.39807980816622,78.6520129391605,20.0
Kerala,9,Alathur ,1266794,493240,522650,2,1015892,22,3484,1019376,80.46896338315464,79.44656073577141,80.91246158728684,50.0
Kerala,10,Thrissur,1337110,488619,551694,5,1040318,45,1804,1042122,77.93838951170808,75.92167599206319,79.55097979841675,29.411764705882355
Kerala,11,Chalakudy,1230197,482031,506846,6,988883,0,1550,990433,80.5101134208586,80.35658023055188,80.41039211580076,75.0
Kerala,12,Ernakulam,1245972,480105,485690,6,965801,0,1589,967390,77.64139162035744,78.99465092823095,76.10429495918144,46.15384615384615
Kerala,13,Idukki,1204191,466078,451489,1,917568,5,1991,919559,76.36321812735687,77.81727354538609,74.59557967051576,33.33333333333333
Kerala,14,Kottayam,1206698,456630,451086,3,907719,15,2929,910648,75.46610668120772,77.19838648051909,73.32490230628686,37.5
Kerala,15,Alappuzha,1356701,520042,562480,0,1082522,196,7590,1090112,80.35020243959427,79.13849487695718,80.40413627877857,0.0
Kerala,16,Mavelikkara ,1308102,450140,514148,1,964289,421,8071,972360,74.33365288027997,72.24398675617854,75.05612991191472,100.0
Kerala,17,Pathanamthitta,1382741,490914,531776,3,1022693,13,4685,1027378,74.30010392401759,73.74447195116089,74.16246189205096,100.0
Kerala,18,Kollam,1296720,445672,515612,4,961288,0,7729,969017,74.72831451662657,71.75689035012864,76.31618676605105,50.0
Kerala,19,Attingal,1350710,458921,540333,4,999258,10,6790,1006048,74.48290158509229,72.47028838349225,75.3138232777005,28.57142857142857
Kerala,20,Thiruvananthapuram,1371427,490244,513476,15,1003735,11,7533,1011268,73.73837615855602,73.75828051207905,72.65518656346836,44.11764705882353
Lakshadweep,1,Lakshadweep,55189,23328,23549,0,46877,0,149,47026,85.20900904165684,83.15688161693936,86.78139740566037,0.0
Madhya Pradesh,1,MORENA,1837723,646523,486232,13,1132768,0,5966,1138734,61.96439833424298,64.71397241571218,57.98049875210616,20.634920634920633
Madhya Pradesh,2,BHIND,1765334,561487,393454,18,954959,0,7758,962717,54.53455266822029,57.98766274875115,49.36743325834294,32.142857142857146
Madhya Pradesh,3,GWALIOR,2000744,621943,570556,27,1192526,0,4362,1196888,59.82214616162788,57.60235542984372,61.9523106323836,40.909090909090914
Madhya Pradesh,4,GUNA,1675724,658166,514437,24,1172627,0,6080,1178707,70.34016341593245,74.02101531668617,65.40681153284281,54.54545454545454
Madhya Pradesh,5,SAGAR,1583129,594998,440864,12,1035874,0,1662,1037536,65.53704720209156,70.72624808473866,59.42981007598848,32.432432432432435
Madhya Pradesh,6,TIKAMGARH,1647399,607602,487321,12,1094935,0,2519,1097454,66.61737684677482,69.40294927296196,63.13265967094183,41.37931034482759
Madhya Pradesh,7,DAMOH,1768777,655175,508615,11,1163801,0,604,1164405,65.83107989305606,70.16291654128172,60.91474821608648,45.83333333333333
Madhya Pradesh,8,KHAJURAHO,1842095,681995,574761,14,1256770,0,1546,1258316,68.30896343565342,70.26095646261307,65.95925121759767,29.78723404255319
Madhya Pradesh,9,SATNA,1575064,586320,525591,5,1111916,0,1839,1113755,70.71172980907441,70.43762824424913,70.77379870326608,15.151515151515152
Madhya Pradesh,10,REWA,1679534,534294,475310,3,1009607,0,5025,1014632,60.411518909411775,59.67451725420424,60.612668584603455,27.27272727272727
Madhya Pradesh,11,SIDHI,1845547,671661,609283,2,1280946,0,1759,1282705,69.502700283439,69.48847429956578,69.31957294401944,10.0
Madhya Pradesh,12,SHAHDOL,1656474,640890,593874,9,1234773,0,3713,1238486,74.76640140442893,75.52606273156658,73.51008378709241,36.0
Madhya Pradesh,13,JABALPUR,1819893,673476,589120,15,1262611,0,1449,1264060,69.45792966949156,71.50572968703051,67.1007775954112,18.51851851851852
Madhya Pradesh,14,MANDLA,1951267,770677,743270,12,1513959,0,3972,1517931,77.79207048548456,78.37379936644176,76.7914686018388,48.0
Madhya Pradesh,15,BALAGHAT,1767725,683773,683107,5,1366885,0,5845,1372730,77.65517826585018,77.21397630415242,77.43572594540673,55.55555555555556
Madhya Pradesh,16,CHHINDWARA,1514783,643874,602327,9,1246210,0,2268,1248478,82.41959409367546,83.20150722405356,81.29754404150673,50.0
Madhya Pradesh,17,HOSHANGABAD,1706141,699824,564814,41,1264679,0,1625,1266304,74.22036045086543,77.92541553043252,69.90194416151306,65.07936507936508
Madhya Pradesh,18,VIDISHA,1741604,695861,550527,21,1246409,0,4604,1251013,71.83108215185541,75.67136408567796,66.9760430961488,46.666666666666664
Madhya Pradesh,19,BHOPAL,2142861,761678,644492,66,1406236,0,2433,1408669,65.73776833868365,67.9006270537034,63.1283033800753,36.0655737704918
Madhya Pradesh,20,RAJGARH,1694329,701961,556087,12,1258060,0,2870,1260930,74.42061134525821,79.67377338702721,68.3776017234362,46.15384615384615
Madhya Pradesh,21,DEWAS,1760503,760239,636493,12,1396744,0,2952,1399696,79.50545951923968,83.15784522627136,75.21255313089728,37.5
Madhya Pradesh,22,UJJAIN,1661229,671867,578580,18,1250465,0,2598,1253063,75.4298775183915,78.96792468353686,71.3990426323538,25.0
Madhya Pradesh,23,MANDSOUR,1760875,729015,639206,15,1368236,0,3299,1371535,77.88940157592106,80.84446908788468,74.40423047867591,57.692307692307686
Madhya Pradesh,24,RATLAM,1851112,721186,676258,11,1397455,0,3880,1401335,75.70233459671807,77.58642576969336,73.38211309772483,37.93103448275862
Madhya Pradesh,25,DHAR,1786151,705191,637344,10,1342545,0,1629,1344174,75.25533955415864,77.5302368484414,72.7119229966242,20.408163265306122
Madhya Pradesh,26,INDORE,2350580,876605,750081,50,1626736,0,2859,1629595,69.32735750325452,72.54153777914595,65.68238378538366,27.77777777777778
Madhya Pradesh,27,KHARGONE,1834385,741129,684159,10,1425298,0,2704,1428002,77.8463626774096,79.76479400910301,75.57905621045865,52.63157894736842
Madhya Pradesh,28,KHANDWA,1909055,774542,691781,18,1466341,0,1815,1468156,76.90485606753079,78.78663964975668,74.71524695158173,23.376623376623375
Madhya Pradesh,29,BETUL,1737437,709766,646805,9,1356580,0,1756,1358336,78.18044625502968,79.07921447337048,77.01242214578191,32.142857142857146
Maharashtra,1,Nandurbar ,1871099,663475,614513,3,1277991,0,6555,1284546,68.65195267594072,70.23024957817921,66.33609071174043,13.636363636363635
Maharashtra,2,Dhule,1908173,590252,489597,7,1079856,0,8722,1088578,57.048181690024954,59.19206242397318,53.744520956210465,33.33333333333333
Maharashtra,3,Jalgaon,1931400,584596,495967,13,1080576,0,11711,1092287,56.55415760588174,57.6073567640329,54.11285025672582,20.3125
Maharashtra,4,Raver,1775051,583456,505236,1,1088693,0,7818,1096511,61.77349270528002,63.03918231960629,59.476124721446254,3.4482758620689653
Maharashtra,5,Buldhana,1762918,601170,516898,1,1118069,0,3082,1121151,63.59632155324297,64.95308169781048,61.72918826221333,11.11111111111111
Maharashtra,6,Akola,1865169,607024,509871,7,1116902,0,3283,1120185,60.05809661215687,62.728726037178994,56.81495034677031,14.583333333333334
Maharashtra,7,Amravati ,1833091,602099,502841,7,1104947,0,8906,1113853,60.76365003155871,63.653220989422834,56.680557606444914,18.91891891891892
Maharashtra,8,Wardha,1743283,573147,494005,6,1067158,0,5499,1072657,61.5308587303381,64.0736355983647,58.20369200897317,33.33333333333333
Maharashtra,9,Ramtek ,1922764,638891,553537,1,1192429,0,5376,1197805,62.29599680460004,64.0098866561201,59.86649636228544,3.125
Maharashtra,10,Nagpur ,2161096,620371,561330,14,1181715,0,5500,1187215,54.93578258439237,56.54711066670192,52.75995082392484,18.181818181818183
Maharashtra,11,Bhandara - gondiya,1811556,627085,608475,0,1235560,0,10983,1246543,68.81062467845321,69.05507579611803,67.34941225953557,0.0
Maharashtra,12,Gadchiroli-Chimur,1581366,580321,557036,1,1137358,0,6376,1143734,72.32569816222177,72.45019619397422,71.38101157143406,33.33333333333333
Maharashtra,13,Chandrapur,1910188,652103,581678,5,1233786,0,5700,1239486,64.88816807560302,66.009009009009,63.07072928221126,20.0
Maharashtra,14,Yavatmal-Washim,1916185,622515,547460,2,1169977,0,4847,1174824,61.310572830911426,62.559983277541555,59.43649004868177,6.25
Maharashtra,15,Hingoli ,1733729,617418,534776,1,1152195,0,6572,1158767,66.83668554889489,68.11835964650979,64.63909027396697,7.6923076923076925
Maharashtra,16,Nanded,1719322,594854,524389,12,1119255,0,10207,1129462,65.69229033304988,66.6441850720718,63.43336030880259,19.047619047619047
Maharashtra,17,Parbhani,1985228,676532,574979,0,1251511,0,1581,1253092,63.12081030491208,65.41420267097777,60.461098434263235,0.0
Maharashtra,18,Jalna,1867220,657947,545873,1,1203821,0,5275,1209096,64.75380512205311,66.4155525855699,62.27445924979465,12.5
Maharashtra,19,Aurangabad,1886284,659019,537423,7,1196449,0,2278,1198727,63.549656361396266,66.30169924645612,60.229701363571664,28.000000000000004
Maharashtra,20,Dindori ,1732936,628124,506627,3,1134754,0,3948,1138702,65.7094087721647,69.38335017867104,61.21418991578362,27.27272727272727
Maharashtra,21,Nashik,1885064,615905,502643,5,1118553,0,3539,1122092,59.52540603395959,62.09934200841697,56.271697623155184,33.33333333333333
Maharashtra,22,Palghar ,1885600,641041,560121,24,1201186,0,1011,1202197,63.75673525668222,64.79776002102507,62.49997210425421,21.62162162162162
Maharashtra,23,Bhiwandi,1890100,569800,432947,16,1002763,0,2842,1005605,53.203798740807365,54.94622059104313,50.757528685031495,13.91304347826087
Maharashtra,24,Kalyan,1965676,507052,380831,72,887955,0,2737,890692,45.31224881414842,47.75103449964496,42.148910337927504,26.373626373626376
Maharashtra,25,Thane,2370903,647401,519722,15,1167138,0,3832,1170970,49.38919896765072,50.02113184805158,48.27509975998157,23.4375
Maharashtra,26,Mumbai North,1647350,542095,445794,167,988056,0,1906,989962,60.09421191610769,60.8984656725405,58.90076844208145,50.30120481927711
Maharashtra,27,Mumbai North West,1732263,521862,418265,4,940131,2,1700,941831,54.369977307141006,54.90642922299484,53.50107701832211,22.22222222222222
Maharashtra,28,Mumbai North East,1588693,503965,403222,41,907228,2,1953,909181,57.228237299465654,58.26218648662709,55.727590977377105,29.496402877697843
Maharashtra,29,Mumbai North central,1679891,495920,404526,5,900451,0,1346,901797,53.6818757883696,54.09302665493008,53.01240502281549,22.727272727272727
Maharashtra,30,Mumbai South central,1440380,432252,363195,31,795478,0,2425,797903,55.39531234813035,55.56345387772627,54.83463325814605,34.065934065934066
Maharashtra,31,Mumbai   South,1554176,438484,361012,5,799501,0,2298,801799,51.58997436583759,51.32255500843313,51.58906176763115,21.73913043478261
Maharashtra,32,Raigad,1652965,505067,515102,0,1020169,0,7414,1027583,62.16604707298703,62.298881482541354,61.1581414456109,0.0
Maharashtra,33,Maval,2298080,743584,621926,5,1365515,0,3941,1369456,59.5913110074497,61.78060931149197,56.82528167038694,12.82051282051282
Maharashtra,34,Pune,2075824,550415,483397,12,1033824,0,1830,1035654,49.89122391879081,51.523718143736396,47.9813274651627,15.0
Maharashtra,35,Baramati,2114663,711804,587435,3,1299242,0,8076,1307318,61.821576298445656,63.990607331998625,58.61027883620531,9.090909090909092
Maharashtra,36,Shirur,2175529,717962,572428,5,1290395,0,2760,1293155,59.440945167818946,62.608142105332,55.644143750060756,11.363636363636363
Maharashtra,37,Ahmadnagar ,1861396,652845,539052,8,1191905,0,14185,1206090,64.79491736309737,66.77464293166298,61.00468072392783,9.090909090909092
Maharashtra,38,Shirdi,1587079,559147,463259,33,1022439,0,8063,1030502,64.93073123644129,67.84331949321381,60.72883675566835,45.20547945205479
Maharashtra,39,Beed,2045405,732331,616806,1,1349138,0,4304,1353442,66.16987833705306,67.58913672676796,64.1239134751434,25.0
Maharashtra,40,Osmanabad,1889740,640975,553782,11,1194768,0,10064,1204832,63.756495602569665,63.81969287690682,62.54865241562209,44.0
Maharashtra,41,Latur ,1886657,625060,545401,3,1170464,0,7625,1178089,62.443199797313454,62.81820648623659,61.169805903425015,33.33333333333333
Maharashtra,42,Solapur ,1851654,586352,494896,6,1081254,0,5090,1086344,58.66884417931212,60.76199121656211,55.819535303406276,10.714285714285714
Maharashtra,43,Madha,1909574,657100,553629,3,1210732,0,7091,1217823,63.77459056313084,65.46157332921562,61.12267282866344,25.0
Maharashtra,44,Sangli,1809109,625663,553143,17,1178823,0,13748,1192571,65.92035084674279,66.90237684829147,63.299681409123785,23.28767123287671
Maharashtra,45,Satara,1848489,578908,530348,4,1109260,0,8497,1117757,60.468685504755506,61.24830984932002,58.71292718838911,23.52941176470588
Maharashtra,46,Ratnagiri - sindhudurg,1455577,447687,449668,0,897355,0,5000,902355,61.99294163070728,62.7863826588428,60.55865530555544,0.0
Maharashtra,47,Kolhapur,1880496,693774,631630,4,1325408,0,7096,1332504,70.85917757868137,72.02788200190614,68.85939331171132,21.052631578947366
Maharashtra,48,Hatkanangle,1776555,659957,586281,18,1246256,1,8057,1254313,70.6036683356271,71.86764601789186,68.31575181806423,26.865671641791046
Manipur,1,Inner manipur,937464,353996,400564,13,754573,0,5883,760456,81.11842161405664,77.57711230180905,83.25708715343669,40.625
Manipur,2,Outer manipur,1022099,414050,437781,4,851835,0,8160,859995,84.14008819106564,81.70679485585623,84.95076018512229,30.76923076923077
Meghalaya,1,Shillong,1197806,361013,421560,0,782573,0,1706,784279,65.47629582753801,61.596643530367245,68.91455811048954,0.0
Meghalaya,2,Tura ,716990,290477,292024,0,582501,0,979,583480,81.37909873219989,79.9045470800209,82.6186838680473,0.0
Mizoram,1,MIZORAM,792464,244562,252218,0,496780,0,3567,500347,63.138136243412944,62.992316628073795,62.3965286058513,0.0
Nagaland,1,Nagaland,1213777,507247,494895,0,1002142,0,5295,1007437,83.00017218978445,82.44245653156155,82.68880857740062,0.0
NCT OF Delhi,1,CHANDNI CHOWK                 ,1562283,540841,438037,43,978921,0,1893,980814,62.78081499958714,63.72761807804156,61.39486316969761,32.57575757575758
NCT OF Delhi,2,NORTH EAST DELHI              ,2290492,807473,650546,27,1458046,0,4721,1462767,63.86256751824499,64.43895930194512,62.71386760549259,31.3953488372093
NCT OF Delhi,3,EAST DELHI                    ,2039302,694305,561981,28,1256314,0,1881,1258195,61.69733565700422,61.45668012395695,61.79173502104508,35.44303797468354
NCT OF Delhi,4,NEW DELHI                     ,1617470,506403,412647,6,919056,0,1511,920567,56.91400767865865,56.49971605267474,57.22045113866267,25.0
NCT OF Delhi,5,NORTH WEST DELHI              ,2378995,775650,626168,24,1401842,0,1144,1402986,58.97389443861799,59.400549549853125,58.35452699384274,15.18987341772152
NCT OF Delhi,6,WEST DELHI                    ,2371644,780000,657076,11,1437087,0,5405,1442492,60.82245058701896,60.92883668103441,60.2047641473994,18.333333333333332
NCT OF Delhi,7,SOUTH DELHI                   ,2067463,683436,529057,18,1212511,0,2034,1214545,58.7456704182856,58.470454469622894,58.88382104808587,13.846153846153847
Odisha,1,Bargarh,1596290,641109,601959,28,1243096,0,7982,1251078,78.37410495586641,78.35315253657285,77.38177265177887,18.421052631578945
Odisha,2,Sundargarh ,1531525,546203,551465,4,1097672,0,3377,1101049,71.89232954081716,71.25378313504488,72.10200826316616,3.2
Odisha,3,Sambalpur,1468530,564201,556953,10,1121164,0,5498,1126662,76.720393863251,75.89671500443919,76.81633553779422,9.523809523809524
Odisha,4,Keonjhar ,1516688,585675,587849,2,1173526,0,2953,1176479,77.56895287626723,76.88021296872417,77.88648176683436,1.4814814814814816
Odisha,5,Mayurbhanj ,1493205,561844,583667,1,1145512,0,6181,1151693,77.12892737433909,75.47852160735971,77.9481269089156,2.5
Odisha,6,Balasore,1531781,577810,576608,3,1154421,0,4934,1159355,75.6867332862857,73.6464293316237,77.1761884111509,3.9473684210526314
Odisha,7,Bhadrak ,1661661,599696,620167,12,1219875,0,8171,1228046,73.90472545242382,69.55973048179453,77.57847701918675,9.67741935483871
Odisha,8,Jajpur ,1475007,556801,529026,21,1085848,0,7117,1092965,74.0989703777677,72.33511572558434,75.01839916618808,35.0
Odisha,9,Dhenkanal,1504403,582956,543693,1,1126650,0,6563,1133213,75.3264251666608,74.12593459132293,75.73929299796058,0.8695652173913043
Odisha,10,Bolangir,1744446,667757,636288,5,1304050,0,2694,1306744,74.90882492206696,74.06634677882707,75.50085671297505,4.032258064516129
Odisha,11,Kalahandi,1611056,608823,614080,3,1222906,0,8023,1230929,76.40510323663486,74.73485350656237,77.1171487953585,2.564102564102564
Odisha,12,Nabarangpur ,1461004,567769,589399,29,1157197,0,4590,1161787,79.51976859748501,79.22022835312552,79.19943133260593,26.126126126126124
Odisha,13,Kandhamal,1288666,471069,468424,5,939498,0,2543,942041,73.10202954062574,72.52593461613073,73.29844898163564,5.952380952380952
Odisha,14,Cuttack,1518996,555577,501846,21,1057444,0,3015,1060459,69.8131528983618,69.79794693076073,69.42851925226611,10.880829015544041
Odisha,15,Kendrapara ,1710916,625161,609709,3,1234873,0,3575,1238448,72.38508494864739,69.78910141484685,74.8102777031363,2.4390243902439024
Odisha,16,Jagatsinghpur ,1643595,634022,591593,0,1225615,0,4212,1229827,74.82542840541618,73.78397407176813,75.44597310643161,0.0
Odisha,17,Puri,1562331,584072,548714,17,1132803,0,3321,1136124,72.71980137371659,71.59368239122841,73.51207820724599,19.101123595505616
Odisha,18,Bhubaneswar,1699678,534680,468962,62,1003704,0,1920,1005624,59.16555959422902,58.836345869857546,59.33268724205902,11.787072243346007
Odisha,19,Aska,1541145,502075,509462,4,1011541,0,2349,1013890,65.78809910813064,61.39817740688927,70.43685165957176,3.3333333333333335
Odisha,20,Berhampur,1502455,486468,500690,5,987163,0,2924,990087,65.89794702669963,63.91769644652043,67.54306681595597,6.25
Odisha,21,Koraput ,1434384,517114,559207,51,1076372,0,4297,1080669,75.34028544657497,75.4277796010648,74.70466510900306,20.238095238095237
Puducherry,1,Puducherry,973410,371347,418834,71,790252,0,643,790895,81.24993579272865,80.81492395044211,81.51518749112027,73.95833333333334
Punjab,1,Gurdaspur,1595284,560368,533051,9,1093428,14,11118,1104546,69.23820460808233,65.94418901314604,71.50449576715106,20.454545454545457
Punjab,2,Amritsar,1507875,466526,390128,4,856658,1,3924,860582,57.07250269418884,58.19651987989606,55.24499488797442,6.896551724137931
Punjab,3,Khadoor Sahib,1638842,542159,498469,8,1040636,1,7514,1048150,63.9567450675538,62.46834290823534,64.66275336468298,10.95890410958904
Punjab,4,Jalandhar,1617018,519020,499182,7,1018209,1,1194,1019403,63.04215537489378,61.52456501793508,64.54383242823894,35.0
Punjab,5,Hoshiarpur,1597500,485078,496757,7,981842,0,9823,991665,62.076056338028174,58.30089240106968,64.89780454506857,23.333333333333332
Punjab,6,Anandpur Sahib,1698876,553140,524356,25,1077521,12,4503,1082024,63.69058130199026,62.18507800959184,64.78905956546666,59.523809523809526
Punjab,7,Ludhiana,1683325,576920,467949,19,1044888,0,2137,1047025,62.19981287036075,63.84513912866413,60.02193348126676,26.76056338028169
Punjab,8,Fatehgarh Sahib,1502861,534375,449101,10,983486,1,3675,987161,65.68544928639442,66.81934300408511,63.874504159442694,32.25806451612903
Punjab,9,Faridkot,1541971,524952,446044,13,971009,2,4233,975242,63.246455348382035,64.15592414976462,61.63467783166826,35.13513513513514
Punjab,10,Firozpur,1618419,625836,540872,9,1166717,0,6084,1172801,72.46584475342912,72.52243743880041,71.59799266377118,25.71428571428571
Punjab,11,Bathinda,1621671,639646,556155,9,1195810,1,6783,1202593,74.15764356642008,74.25767976530874,73.15287847379331,45.0
Punjab,12,Sangrur,1529431,595750,506594,9,1102353,0,4903,1107256,72.39659716587411,73.11116701744483,70.89682891773995,36.0
Punjab,13,Patiala,1739600,632621,542886,21,1175528,0,3319,1178847,67.76540584042309,69.16861559117741,65.81082506282435,28.37837837837838
Rajasthan,1,Ganganagar,1943486,763551,680832,11,1444394,0,8691,1453085,74.76693940681847,75.01974847710748,73.55090038361776,44.0
Rajasthan,2,Bikaner (SC),1851628,613781,481912,5,1095698,0,4802,1100500,59.434184404210775,62.75096562596486,55.170866294977614,31.25
Rajasthan,3,Churu,2019104,687931,632219,1,1320151,0,10521,1330672,65.90408418783778,64.78705711062182,66.0443033015936,20.0
Rajasthan,4,Jhunjhunu,1937882,601852,578034,1,1179887,0,23815,1203702,62.11430830153745,58.82113781409123,63.19445583262544,100.0
Rajasthan,5,Sikar,2041612,667944,643401,4,1311349,0,19312,1330661,65.17697779989537,62.013701720653124,66.70706685315034,100.0
Rajasthan,6,Jaipur Rural,1952542,675930,587365,1,1263296,0,16371,1279667,65.5385133840911,65.54510862608656,63.75441906103704,20.0
Rajasthan,7,Jaipur,2127021,784372,663540,12,1447924,0,8582,1456506,68.47633380206402,70.06593257387155,65.85880762546414,48.0
Rajasthan,8,Alwar,1888524,673164,579086,3,1252253,0,16224,1268477,67.16763991349859,67.14933246083744,65.35767573412066,30.0
Rajasthan,9,BHARATPUR,1943794,620165,517998,5,1138168,0,10803,1148971,59.10971018533857,59.55251470411716,57.40175175751988,45.45454545454545
Rajasthan,10,KARAULI-DHOLPUR,1810574,554132,440287,2,994421,0,4709,999130,55.18305244635127,56.76081527628967,52.7730965525673,14.285714285714285
Rajasthan,11,Dausa,1730289,573319,483328,0,1056647,0,7431,1064078,61.49712562467889,62.59904635975625,59.3457002951765,0.0
Rajasthan,12,TONK-SAWAI MADHOPUR,1945992,663862,564693,0,1228555,0,5912,1234467,63.43638617219393,64.81824661439772,61.2597512912223,0.0
Rajasthan,13,Ajmer,1876346,652041,604830,7,1256878,0,6368,1263246,67.32478977757833,68.08761029603717,65.83656621863449,58.333333333333336
Rajasthan,14,Nagaur,1933169,618537,577497,2,1196036,0,8737,1204773,62.32114212466681,61.307875980148744,62.482228988009844,25.0
Rajasthan,15,Pali,2161663,686790,658426,9,1345225,0,16290,1361515,62.984609534418645,60.89616556053573,63.6874177822487,50.0
Rajasthan,16,Jodhpur,1956755,711438,623545,2,1334985,5,12948,1347933,68.88614057457372,69.31789726806198,67.01873594696497,20.0
Rajasthan,17,Barmer,1941231,746375,671560,6,1417941,0,4934,1422875,73.29756221696438,72.2317493559507,73.96752108133828,46.15384615384615
Rajasthan,18,Jalore,2071244,699922,660874,3,1360799,0,828,1361627,65.7395748641879,64.24096350155939,67.31900112559272,23.076923076923077
Rajasthan,19,Udaipur,2069559,722674,725529,0,1448203,0,7214,1455417,70.32498227883332,68.85895079461724,71.12617995625743,0.0
Rajasthan,20,Banswara,1975368,704324,733142,4,1437470,0,2639,1440109,72.90332738001223,70.64971853421123,74.9299137297547,57.14285714285714
Rajasthan,21,Chittorgarh,2015911,755697,698787,5,1454489,0,4777,1459266,72.3874218653502,74.24239447163609,70.01726416578408,41.66666666666667
Rajasthan,22,Rajsamand,1912911,620927,613083,7,1234017,0,6831,1240848,64.86700113073739,63.10278630030904,66.00075573014621,46.666666666666664
Rajasthan,23,Bhilwara,1997328,666299,641037,1,1307337,0,3674,1311011,65.63824269223683,65.57570496695129,65.32881119636545,20.0
Rajasthan,24,Kota,1948010,722450,637676,6,1360132,0,7796,1367928,70.22181610977356,71.77330583405856,67.73540452634418,37.5
Rajasthan,25,JHALAWAR-BARAN,1903870,732783,636485,8,1369276,0,741,1370017,71.95958757688288,75.02933461115514,68.64651550056514,50.0
Sikkim,1,Sikkim,434128,173235,166645,0,339880,0,13535,353415,81.40801791176796,77.99513754445995,78.59945853653934,0.0
Tamil Nadu,1,Thiruvallur ,1946870,711490,691821,38,1403349,0,4916,1408265,72.33482461592196,73.92695311728833,70.29979646398084,10.982658959537572
Tamil Nadu,2,Chennai North,1487681,477845,474835,90,952770,0,3161,955931,64.25645013951244,65.55871260191994,62.61472366102983,19.736842105263158
Tamil Nadu,3,Chennai South,1973533,567542,555856,12,1123410,0,2931,1126341,57.07231650040815,57.93266629783047,55.95005868225622,3.0848329048843186
Tamil Nadu,4,Chennai central,1332300,399357,383273,56,782686,0,3071,785757,58.97748254897546,60.453953015227135,57.08997853575413,15.819209039548024
Tamil Nadu,5,Sriperumbudur,2253448,717038,686116,24,1403178,0,3975,1407153,62.444440697100625,63.84584494206541,60.71656441283469,7.0588235294117645
Tamil Nadu,6,Kancheepuram ,1643992,623089,609297,31,1232417,0,5741,1238158,75.31411345067373,77.2817814689131,72.74640832988085,17.91907514450867
Tamil Nadu,7,Arakkonam,1500016,580530,589120,27,1169677,0,10035,1179712,78.64662776930379,78.84561319159512,77.14528907221894,34.177215189873415
Tamil Nadu,8,Vellore,1438643,503311,521692,39,1025042,0,3058,1028100,71.46317745264113,71.1560592308584,71.34698387864398,37.142857142857146
Tamil Nadu,9,Krishnagiri,1530404,588058,569700,35,1157793,0,4480,1162273,75.94550197202831,75.7186120653691,75.60395577095598,14.83050847457627
Tamil Nadu,10,Dharmapuri,1485804,617619,594650,42,1212311,0,12154,1224465,82.41093710879767,81.57833908124165,81.61688309014572,32.30769230769231
Tamil Nadu,11,Tiruvannamalai,1473862,565142,579380,27,1144549,0,7242,1151791,78.14781845247384,77.33873792997746,77.97332342819921,35.064935064935064
Tamil Nadu,12,Arani,1449150,566134,571075,16,1137225,0,7692,1144917,79.00610702825794,78.87675985203659,78.0875039483022,20.51282051282051
Tamil Nadu,13,Viluppuram,1444335,564557,566199,43,1130799,0,5299,1136098,78.65889838576231,78.23108890283834,78.36696899779515,23.243243243243246
Tamil Nadu,14,Kallakurichi,1528938,580683,617701,39,1198423,0,6512,1204935,78.80862402530384,76.57977612255233,80.17020403978263,21.787709497206702
Tamil Nadu,15,Salem,1612512,639561,610150,44,1249755,0,6575,1256330,77.91135817903991,78.93135046743389,76.06461159862221,48.888888888888886
Tamil Nadu,16,Namakkal,1413599,555962,573885,43,1129890,0,4094,1133984,80.21963795956279,79.92599152381554,79.94029742635382,38.73873873873874
Tamil Nadu,17,Erode,1462246,529075,532968,30,1062073,0,6930,1069003,73.10691908201493,73.91638433865391,71.40830181398695,28.846153846153843
Tamil Nadu,18,Tiruppur,1530014,566137,549529,27,1115693,0,4400,1120093,73.20802293312349,74.18831934667178,71.66803604731537,19.852941176470587
Tamil Nadu,19,Nilgiris ,1366060,499957,507807,10,1007774,0,3275,1011049,74.01204925113099,75.09432658627878,72.52116837732196,14.492753623188406
Tamil Nadu,20,Coimbatore,1958904,634627,610981,36,1245644,0,5285,1250929,63.85861685922332,64.86011109350966,62.32998992079458,16.901408450704224
Tamil Nadu,21,Pollachi,1520504,536887,540497,36,1077420,0,4468,1081888,71.15324918579628,71.98613606500228,69.78558083745745,20.809248554913296
Tamil Nadu,22,Dindigul,1541881,568983,586609,15,1155607,0,5324,1160931,75.29316464759603,75.37576404693837,74.55052417135937,9.49367088607595
Tamil Nadu,23,Karur,1387286,532989,564924,34,1097947,0,5698,1103645,79.55425197111482,78.49443679447435,79.7685412677703,50.74626865671642
Tamil Nadu,24,Tiruchirappalli,1508963,513314,527326,71,1040711,0,8068,1048779,69.50329464672096,69.38147688090581,68.57544878096992,47.97297297297297
Tamil Nadu,25,Perambalur,1391853,524468,570254,32,1094754,0,8406,1103160,79.2583699571722,77.20962551414885,80.03643544568158,39.02439024390244
Tamil Nadu,26,Cuddalore ,1364038,505581,533135,25,1038741,0,4639,1043380,76.49200388845472,75.0082340059997,77.27568548498144,27.472527472527474
Tamil Nadu,27,Chidambaram ,1480222,553860,595522,3,1149385,0,4872,1154257,77.97864104168158,75.07349981091335,80.21513834748103,5.084745762711865
Tamil Nadu,28,Mayiladuthurai,1484842,529933,562966,18,1092917,0,4863,1097780,73.93244533761842,72.07629083876127,75.10689704397154,36.0
Tamil Nadu,29,Nagapattinam ,1303649,476344,521489,10,997843,0,5077,1002920,76.93175080102083,74.03094932075923,78.99313813108745,25.0
Tamil Nadu,30,Thanjavur,1461052,495980,556575,15,1052570,0,7482,1060052,72.55402271787726,69.68693008264417,74.28636638464342,15.463917525773196
Tamil Nadu,31,Sivaganga,1552019,495947,585207,13,1081167,0,3739,1084906,69.90288134359179,64.62565886775734,74.59256275667973,19.696969696969695
Tamil Nadu,32,Madurai,1539026,500312,511142,46,1011500,0,5622,1017122,66.08868206255126,65.93802264481174,65.51683032778796,47.91666666666667
Tamil Nadu,33,Theni ,1561040,571213,596677,29,1167919,0,7089,1175008,75.27084507764054,73.65814218586394,75.97448320207802,15.846994535519126
Tamil Nadu,34,Virudhunagar,1484256,520544,544786,12,1065342,0,10584,1075926,72.48924713796004,71.53267619530548,72.0211521300856,9.230769230769232
Tamil Nadu,35,Ramanathapuram,1559740,491515,569601,8,1061124,0,5799,1066923,68.40390065010835,63.21199743815959,72.83043427115992,9.75609756097561
Tamil Nadu,36,Thoothukkudi,1427783,478152,507621,36,985809,0,6158,991967,69.47603382306696,68.043420101435,70.02142213749619,31.03448275862069
Tamil Nadu,37,Tenkasi ,1492317,506970,548621,4,1055595,0,10413,1066008,71.43308023697378,68.89986096897692,72.52747107472979,5.128205128205128
Tamil Nadu,38,Tirunelveli,1547800,499295,533224,11,1032530,0,7860,1040390,67.2173407416979,65.70682591925335,67.68098963126182,16.176470588235293
Tamil Nadu,39,Kanniyakumari,1501250,510999,531602,24,1042625,0,6802,1049427,69.9035470441299,67.16318451379543,71.81297356735953,15.09433962264151
Telangana,1,Adilabad ,1489790,523054,539832,9,1062895,0,1082,1063977,71.4179179615919,71.48945126918261,71.21023847024465,16.071428571428573
Telangana,2,Peddapalle ,1479091,484439,484738,21,969198,0,967,970165,65.59197507117547,65.40842544998428,65.64965308767545,25.301204819277107
Telangana,3,Karimnagar ,1651543,558800,588108,7,1146915,0,1286,1148201,69.52292492535767,68.49197535857779,70.37756373205433,20.588235294117645
Telangana,4,Nizamabad,1553385,474024,587594,4,1061622,0,1560,1063182,68.44291659826766,64.22445445849603,72.07248534862784,13.793103448275861
Telangana,5,Zahirabad,1498666,514518,529323,2,1043843,0,661,1044504,69.69558260479654,69.70437977465072,69.6054503709587,3.278688524590164
Telangana,6,Medak,1603318,581947,567533,10,1149490,0,841,1150331,71.74690236122841,72.81655563841662,70.58157076214958,24.390243902439025
Telangana,7,Malkajgiri,3150313,823072,738294,34,1561400,0,2246,1563646,49.634623607241565,50.246939356089605,48.831874913189274,9.742120343839542
Telangana,8,Secundrabad,1968276,488024,426124,6,914154,0,1109,915263,46.50074481424353,47.61079697335097,45.179068034084366,10.16949152542373
Telangana,9,Hyderabad,1957931,479564,397698,5,877267,0,674,877941,44.84024207186055,47.36331655015891,42.07211219568444,3.787878787878788
Telangana,10,CHEVELLA,2443112,678645,620290,18,1298953,0,2045,1300998,53.2516724570957,53.665049810453006,52.643326589085184,7.82608695652174
Telangana,11,Mahbubnagar,1506102,494155,489732,4,983891,0,876,984767,65.3851465571389,65.70283975928925,64.95489795837163,10.256410256410255
Telangana,12,Nagarkurnool,1588111,502620,486427,1,989048,0,845,989893,62.33147431130443,62.94623233073384,61.605712396828196,2.564102564102564
Telangana,13,Nalgonda,1585980,585803,588944,3,1174750,0,1234,1175984,74.14872823112523,74.65949048790964,73.4967303948485,11.11111111111111
Telangana,14,Bhongir ,1628033,616922,594332,2,1211256,0,1521,1212777,74.49339171871823,75.32036568570955,73.47055834865175,6.666666666666667
Telangana,15,Warangal,1666770,530268,530078,66,1060412,0,1260,1061672,63.696370825008856,63.92360047930525,63.32661931010425,36.26373626373626
Telangana,16,Mahabubabad  ,1424385,485104,497622,8,982734,0,973,983707,69.06187582711135,69.01278810218531,68.97822208730294,17.02127659574468
Telangana,17,Khammam ,1513809,559568,578825,32,1138425,0,1423,1139848,75.29668538104873,75.58716457628378,74.83696382950114,48.484848484848484
Tripura,1,Tripura West,1352857,559005,542353,4,1101362,0,7065,1108427,81.93231065811094,81.31632348769719,81.50756986002446,40.0
Tripura,2,Tripura East,1261861,529358,511554,1,1040913,0,5210,1046123,82.90318822754645,82.51685463317303,82.46322190017764,25.0
Uttar Pradesh,1,Saharanpur,1739082,663829,565077,9,1228915,0,3523,1232438,70.86715865036841,71.32048875714597,69.91528412050515,10.975609756097562
Uttar Pradesh,2,Kairana,1666703,606832,514021,10,1120863,0,3350,1124213,67.45130956145155,67.4078772414881,67.07208388626397,10.75268817204301
Uttar Pradesh,3,Muzaffarnagar,1698003,624979,529210,3,1154192,0,7582,1161774,68.42002045932782,67.83819016823351,68.14333522616799,2.7027027027027026
Uttar Pradesh,4,Bijnor,1664125,585728,510581,4,1096313,0,5653,1101966,66.21894388943139,65.39295861918824,66.45248197412604,5.0
Uttar Pradesh,5,Nagina,1586117,515070,490879,6,1005955,0,3830,1009785,63.66396678176957,61.03976288978665,66.13569917680503,10.0
Uttar Pradesh,6,Moradabad,1958939,691615,588042,12,1279669,0,2596,1282265,65.45711734770711,65.94226458521442,64.61836678853172,12.371134020618557
Uttar Pradesh,7,Rampur,1679506,565546,494611,4,1060161,0,1077,1061238,63.18750870791769,62.65923902084482,63.67542988970981,2.4539877300613497
Uttar Pradesh,8,Sambhal,1828764,645902,536303,4,1182209,0,1579,1183788,64.73158920451189,65.53787771171135,63.61106729118951,3.149606299212598
Uttar Pradesh,9,Amroha,1646435,616570,550735,3,1167308,0,2446,1169754,71.04768788321434,70.33468206971526,71.54939348626202,3.5294117647058822
Uttar Pradesh,10,Meerut,1892931,673088,538984,4,1212076,0,4864,1216940,64.28866134053486,65.12483853957534,62.7263131311368,3.007518796992481
Uttar Pradesh,11,Baghpat,1616476,581282,455777,2,1037061,0,8546,1045607,64.6843504017381,64.79206375745417,63.36916277019803,2.3529411764705883
Uttar Pradesh,12,Ghaziabad,2728978,854916,666970,6,1521892,0,3205,1525097,55.885280130510395,56.24676796027206,55.17022890471003,5.5045871559633035
Uttar Pradesh,13,Gautam Buddha Nagar,2302960,773558,616093,4,1389655,0,3486,1393141,60.493495327752115,60.99056707907443,59.554491383785255,3.007518796992481
Uttar Pradesh,14,Bulandshahr,1787925,584669,533764,9,1118442,0,6558,1125000,62.92210243718277,61.34824292548107,63.939376878450695,9.473684210526317
Uttar Pradesh,15,Aligarh,1887127,625385,530640,5,1156030,0,7920,1163950,61.678413800449036,61.78985412739251,60.6519189753273,4.273504273504273
Uttar Pradesh,16,Hathras,1864320,621305,522728,2,1144035,0,7426,1151461,61.76305569859252,61.530820622215884,61.17269271818301,3.225806451612903
Uttar Pradesh,17,Mathura,1807893,611218,486892,2,1098112,0,6213,1104325,61.083537576615434,62.09955753336279,59.12930695281722,0.9900990099009901
Uttar Pradesh,18,Agra,1937690,644571,496879,5,1141455,0,4174,1145629,59.123440798063676,60.945597508360784,56.4651268501946,5.1020408163265305
Uttar Pradesh,19,Fatehpur Sikri,1718837,580669,450331,4,1031004,0,7456,1038460,60.41643273911371,61.723918737350544,57.880706859477684,7.6923076923076925
Uttar Pradesh,20,Firozabad,1790510,592593,479885,2,1072480,0,4094,1076574,60.126667820900195,61.447124881402324,58.0957696144422,2.197802197802198
Uttar Pradesh,21,Mainpuri,1723236,543014,429681,2,972697,0,5564,978261,56.768834912919644,58.132693283545336,54.453138068950835,3.4482758620689653
Uttar Pradesh,22,Etah,1621295,536075,461773,5,997853,0,2499,1000352,61.700800902981875,60.99892242728091,62.19818378226938,10.869565217391305
Uttar Pradesh,23,Badaun,1891576,592408,486684,9,1079101,0,2373,1081474,57.17317200049059,57.6722868154794,56.31072229813614,9.375
Uttar Pradesh,24,Aonla,1785605,580835,469654,4,1050493,0,2409,1052902,58.966120726588464,59.43049210352642,58.11233346902868,4.597701149425287
Uttar Pradesh,25,Bareilly,1797655,589861,475904,3,1065768,0,3188,1068956,59.4639127085008,60.20580949455009,58.190995450160244,3.614457831325301
Uttar Pradesh,26,Pilibhit,1761207,639291,543594,5,1182890,0,4335,1187225,67.40973661812609,67.38095915663527,66.91540696243045,6.578947368421052
Uttar Pradesh,27,Shahjahanpur,2114201,664430,515538,6,1179974,0,7159,1187133,56.1504322436703,57.36969576611075,53.93283111323595,3.821656050955414
Uttar Pradesh,28,Kheri,1770699,623854,512343,6,1136203,0,569,1136772,64.19905359408912,65.87729172518516,62.20253524170511,16.666666666666664
Uttar Pradesh,29,Dhaurahra,1644674,598573,464597,8,1063178,0,775,1063953,64.69081410662538,67.66243220452023,61.1365738821712,8.421052631578947
Uttar Pradesh,30,Sitapur,1666126,585694,477676,8,1063378,0,1844,1065222,63.934060209131836,65.79049942655978,61.57078482526784,11.594202898550725
Uttar Pradesh,31,Hardoi,1807119,587977,467415,0,1055392,0,2455,1057847,58.537760933286634,59.92238321047745,56.59928411589766,0.0
Uttar Pradesh,32,Misrikh,1796932,572540,452522,1,1025063,0,2319,1027382,57.17422807318251,58.69875239264005,55.087191785407775,1.25
Uttar Pradesh,33,Unnao,2191465,677560,557981,5,1235546,0,2005,1237551,56.471401551017244,56.38650671793015,56.376921856702765,5.154639175257731
Uttar Pradesh,34,Mohanlalganj,2023431,700199,563737,0,1263936,0,6644,1270580,62.793344571670595,64.65890118495317,59.94466355248509,0.0
Uttar Pradesh,35,Lucknow,2040367,609363,497734,3,1107100,6,10530,1117630,54.77593001651173,55.57574182250982,52.73639431456376,3.0927835051546393
Uttar Pradesh,36,Rae Bareli,1702248,486873,468447,1,955321,0,3701,959022,56.33855936385298,54.33050041734923,58.11521637186037,2.0
Uttar Pradesh,37,Amethi,1743515,479441,461540,0,940981,0,1975,942956,54.08361843746684,51.85595789578428,56.36702930587241,0.0
Uttar Pradesh,38,Sultanpur,1775196,499120,499917,4,999041,0,1723,1000764,56.3748453691874,53.723522769960375,59.08695498008439,5.47945205479452
Uttar Pradesh,39,Pratapgarh,1708759,460484,449531,0,910015,0,5244,915259,53.562790305713094,50.24156065201737,56.74535149395978,0.0
Uttar Pradesh,40,Farrukhabad,1708585,551171,449196,6,1000373,0,2868,1003241,58.71765232634022,59.28571582233141,57.676336826643315,7.792207792207792
Uttar Pradesh,41,Etawah,1757984,558464,464983,3,1023450,0,5361,1028811,58.5222049802501,58.36325709914346,58.04581917504513,6.521739130434782
Uttar Pradesh,42,Kannauj,1874824,622274,514822,4,1137100,0,3885,1140985,60.85824589401459,60.654625559248686,60.65084958218912,6.153846153846154
Uttar Pradesh,43,Kanpur,1632983,475353,362893,7,838253,0,5166,843419,51.64897613753481,53.19027754776856,49.09472664573325,5.384615384615385
Uttar Pradesh,44,Akbarpur,1766121,572760,446366,16,1019142,0,7491,1026633,58.12925614949373,59.37287171018873,55.702934984581944,15.238095238095239
Uttar Pradesh,45,Jalaun,1933358,620288,506493,2,1126783,0,3963,1130746,58.48611586679756,59.05800516612825,57.36229461409875,2.4096385542168677
Uttar Pradesh,46,Jhansi,2040739,745494,633910,3,1379407,0,1723,1381130,67.67793431693127,69.02217337805845,65.99139075260646,4.615384615384616
Uttar Pradesh,47,Hamirpur,1749100,590920,496952,14,1087886,0,2143,1090029,62.3194214167286,61.94987147068567,62.494356730110226,37.83783783783784
Uttar Pradesh,48,Banda,1702024,551269,481995,12,1033276,0,1636,1034912,60.80478301128539,59.46627286338708,62.19828036746402,19.047619047619047
Uttar Pradesh,49,Fatehpur,1839312,552984,486248,2,1039234,0,5255,1044489,56.786939899266685,55.350540208876765,57.873369571039035,3.278688524590164
Uttar Pradesh,50,Kaushambi,1787120,507213,464469,3,971685,0,3352,975037,54.55912305832848,52.79212385014582,56.2258043429313,1.1194029850746268
Uttar Pradesh,51,Phulpur,2010477,538435,435879,12,974326,0,4751,979077,48.69874164190886,48.841495882214744,48.012226689431074,5.607476635514018
Uttar Pradesh,52,Allahabad,1716160,494017,392794,4,886815,0,2738,889553,51.83391991422711,52.54829170744161,50.6275697621963,2.1052631578947367
Uttar Pradesh,53,Barabanki,1816830,637599,517214,5,1154818,0,890,1155708,63.61123495318769,65.7275867649833,61.084997023781405,9.090909090909092
Uttar Pradesh,54,Faizabad,1821785,571394,514352,20,1085766,0,1654,1087420,59.689809719588204,58.67046444002695,60.66730830927174,35.08771929824561
Uttar Pradesh,55,Ambedkar Nagar,1785657,556597,531868,0,1088465,0,2150,1090615,61.07639933089053,58.10723483863829,64.25683985686015,0.0
Uttar Pradesh,56,Bahraich,1729908,528086,460816,8,988910,0,1233,990143,57.23674322565131,57.412509105141275,56.89205822838257,6.956521739130435
Uttar Pradesh,57,Kaiserganj,1805946,522251,457572,0,979823,0,2500,982323,54.393819084291565,53.92180346792163,54.64570671755779,0.0
Uttar Pradesh,58,Shrawasti,1914739,548122,448359,5,996486,0,653,997139,52.07701937444216,52.805282435747,51.14394275552352,6.944444444444445
Uttar Pradesh,59,Gonda,1770248,490088,432094,2,922184,0,1939,924123,52.203024660951456,50.91754604872869,53.499293641035926,2.7777777777777777
Uttar Pradesh,60,Domariyaganj,1885433,489185,495930,0,985115,0,215,985330,52.26014395632197,48.05646316376833,57.17932398965092,0.0
Uttar Pradesh,61,Basti,1845223,537937,510947,1,1048885,0,6316,1055201,57.18555426634071,53.92143989110202,60.29193290499201,0.7299270072992701
Uttar Pradesh,62,Sant Kabir Nagar,1962903,527427,533378,1,1060806,0,3119,1063925,54.20160853592867,49.44719293261969,59.51790074138216,1.0869565217391304
Uttar Pradesh,63,Maharajganj,1915408,607060,618619,7,1225686,0,1538,1227224,64.07115350880856,59.30335700023055,69.39134687541014,2.6615969581749046
Uttar Pradesh,64,Gorakhpur,1981197,627713,553509,0,1181222,0,3703,1184925,59.8085399887038,57.82527309140018,61.81094756261118,0.0
Uttar Pradesh,65,Kushi Nagar,1761564,526776,522399,4,1049179,0,4130,1053309,59.79396717916578,55.23330002547894,64.67775583605197,2.857142857142857
Uttar Pradesh,66,Deoria,1754195,506109,502783,4,1008896,0,6700,1015596,57.89527390056408,52.85993150577626,63.11247404744391,4.166666666666666
Uttar Pradesh,67,Bansgaon,1751258,482600,482462,2,965064,0,4719,969783,55.37636373395583,50.19700190969117,61.0897754884718,2.2988505747126435
Uttar Pradesh,68,Lalganj,1751980,468375,489947,0,958322,0,2742,961064,54.85587735019806,50.071037532832804,60.00377207367301,0.0
Uttar Pradesh,69,Azamgarh,1789168,523819,501829,0,1025648,0,4148,1029796,57.557255662967364,53.813832262677586,61.52066670916554,0.0
Uttar Pradesh,70,Ghosi,1991651,589077,548040,0,1137117,0,4363,1141480,57.313254179572624,54.881433401374935,59.68621283769803,0.0
Uttar Pradesh,71,Salempur,1667282,469667,446144,0,915811,0,8290,924101,55.425596869635726,51.61090751251353,58.919687747207824,0.0
Uttar Pradesh,72,Ballia,1822625,531670,449438,4,981112,0,9459,990571,54.34859063164392,52.90127688620061,54.97383031475789,7.547169811320755
Uttar Pradesh,73,Jaunpur,1867976,520123,518437,0,1038560,0,3273,1041833,55.77336111384729,52.48169629163236,59.12662161776865,0.0
Uttar Pradesh,74,Machhlishahr,1848306,511790,520320,1,1032111,0,3299,1035410,56.01940371345437,51.916789495520845,60.3320628876415,1.1111111111111112
Uttar Pradesh,75,Ghazipur,1881077,580248,519642,0,1099890,0,7607,1107497,58.87568664121671,56.349364349787756,61.042071691619135,0.0
Uttar Pradesh,76,Chandauli,1756837,589802,490253,5,1080060,0,6133,1086193,61.82662364237548,61.352262526044456,61.63696208642826,4.464285714285714
Uttar Pradesh,77,Varanasi,1856791,606306,452435,3,1058744,0,2085,1060829,57.132385928195475,59.030116452620106,54.53915328607937,2.5423728813559325
Uttar Pradesh,78,Bhadohi,1942514,540234,496990,5,1037229,0,2634,1039863,53.531814957318204,50.91426923490151,56.394428526850305,2.8901734104046244
Uttar Pradesh,79,Mirzapur,1845150,587558,520101,1,1107660,0,1399,1109059,60.106712191420755,60.341576633939944,59.69424119824396,0.6451612903225806
Uttar Pradesh,80,Robertsganj,1723538,534178,453411,0,987589,0,1215,988804,57.37059467212211,57.53562465667847,57.028167508316926,0.0
Uttarakhand,1,Tehri Garhwal,1493543,428054,435743,9,863806,0,15377,879183,58.865596772238895,54.34647090862692,61.73282538998913,17.647058823529413
Uttarakhand,2,Garhwal,1355796,330296,391050,3,721349,0,26673,748022,55.17216454392844,46.610041530430955,60.428726399495616,9.090909090909092
Uttarakhand,3,Almora,1337808,309061,368861,2,677924,0,21883,699807,52.30997273151304,44.46389855599978,57.3906211102813,40.0
Uttarakhand,4,Nainital-udhamsingh Nagar,1828433,647658,601589,9,1249256,0,11754,1261010,68.96670537011748,67.04666033803977,69.75543408941752,34.61538461538461
Uttarakhand,5,Hardwar,1840738,671478,593713,22,1265213,0,8180,1273393,69.17839475253948,68.13466245093942,69.4324834462644,17.1875
West Bengal,1,Cooch behar,1814200,778609,741742,1,1520352,0,5094,1525446,84.08367324440525,82.39475371809172,85.33420768044914,16.666666666666664
West Bengal,2,Alipurduars,1648383,689356,686548,1,1375905,0,5271,1381176,83.78975031894893,82.42749767432962,84.5458732430096,4.3478260869565215
West Bengal,3,Jalpaiguri,1735464,769205,728505,1,1497711,0,3668,1501379,86.51167641622067,86.52338433365504,86.06775263695134,5.555555555555555
West Bengal,4,Darjeeling,1611317,642333,617792,0,1260125,0,9541,1269666,78.79678548665471,78.55487490934794,77.84589136463926,0.0
West Bengal,5,Raiganj,1601220,639728,632825,4,1272557,0,5519,1278076,79.81888809782541,76.93060674751824,82.22703275827793,8.333333333333332
West Bengal,6,Balurghat,1431704,605721,589598,21,1195340,0,2897,1198237,83.69306784083861,82.11106366538563,84.9617483504021,33.87096774193548
West Bengal,7,Maldaha Uttar,1685955,661444,690382,4,1351830,0,3537,1355367,80.39164746390028,76.4287257680784,84.14541545444463,7.547169811320755
West Bengal,8,Maldaha Dakshin,1575590,625059,650335,4,1275398,0,4579,1279977,81.23794895880273,77.88130514254672,84.13380993224897,11.76470588235294
West Bengal,9,Jangipur,1616213,638429,664486,1,1302916,0,1713,1304629,80.72135294048495,77.27059820266876,84.11779524449109,2.4390243902439024
West Bengal,10,Baharampur,1638378,641365,654690,2,1296057,0,4976,1301033,79.409818735359,76.08378451478815,82.31304833246581,5.0
West Bengal,11,Murshidabad,1725187,720758,731221,4,1451983,0,2209,1454192,84.29184778229838,81.47850042787749,86.99212429808699,14.285714285714285
West Bengal,12,Krishnanagar,1631698,688470,672857,4,1361331,0,5270,1366601,83.75330483949848,81.10429158764005,85.95658844615457,9.75609756097561
West Bengal,13,Ranaghat,1762252,749675,729275,5,1478955,0,5842,1484797,84.25565696620006,82.34205439128334,85.6193734414697,10.416666666666668
West Bengal,14,Bangaon,1704632,716577,687887,2,1404466,0,4187,1408653,82.63678025521051,81.78618264493089,83.03301345886898,8.695652173913043
West Bengal,15,Barrackpore,1436431,579960,522600,7,1102567,0,2132,1104699,76.90581726515231,78.12960979651221,75.2920701285267,24.137931034482758
West Bengal,16,Dum dum,1566196,619195,583905,7,1203107,0,1588,1204695,76.91853382335289,79.23921041686663,74.4085848854635,16.27906976744186
West Bengal,17,Barasat,1718252,729072,664191,7,1393270,0,2924,1396194,81.25664919930254,83.54153632494791,78.55581654449072,15.909090909090908
West Bengal,18,Basirhat,1678357,753166,679304,6,1432476,0,1293,1433769,85.42693836889292,87.10595555452753,83.48581007673816,23.076923076923077
West Bengal,19,Jaynagar,1648355,710417,644971,3,1355391,0,995,1356386,82.28725001592497,83.89510056778995,80.46989043126315,5.263157894736842
West Bengal,20,Mathurapur,1652096,722868,678047,4,1400919,0,1100,1402019,84.8630466994654,84.75621981547206,84.84188345935692,14.285714285714285
West Bengal,21,Diamond harbour,1719190,745450,662528,9,1407987,0,1386,1409373,81.97889703872173,84.03697649512429,79.6227303974118,16.071428571428573
West Bengal,22,Jadavpur,1816857,743145,691668,13,1434826,0,2457,1437283,79.10820719517277,81.68609859555903,76.25677351781924,17.333333333333336
West Bengal,23,Kolkata Dakshin,1728851,638271,565962,3,1204236,0,2840,1207076,69.8195506726722,71.16372414023782,68.03139270572764,9.090909090909092
West Bengal,24,Kolkata Uttar,1444082,527881,421566,6,949453,0,1186,950639,65.82998749378498,66.43973891351574,64.90213858709458,40.0
West Bengal,25,Howrah,1633925,656812,564529,18,1221359,0,1349,1222708,74.83256575424208,76.93880969589343,72.35529044446552,69.23076923076923
West Bengal,26,Uluberia,1614988,676981,633018,18,1310017,0,1103,1311120,81.18450415730643,81.31708547542401,80.90441664206374,43.90243902439025
West Bengal,27,Srerampur,1785472,722334,677696,12,1400042,0,2217,1402259,78.5371599218582,78.83332605753701,77.97191291761875,31.57894736842105
West Bengal,28,Hooghly,1766601,735764,719695,9,1455468,0,3166,1458634,82.56725768863484,82.49344661881409,82.28292397380007,25.0
West Bengal,29,Arambagh,1764726,745780,724650,2,1470432,0,2030,1472462,83.43856213372501,82.29460005826323,84.41121242760427,11.11111111111111
West Bengal,30,Tamluk,1694646,731556,712353,7,1443916,0,3024,1446940,85.38302394718424,83.31569962177682,87.23829234838836,21.21212121212121
West Bengal,31,Kanthi,1660147,723072,698678,0,1421750,0,3216,1424966,85.83372436296304,84.08596148478928,87.31117598248474,0.0
West Bengal,32,Ghatal,1800002,738122,748473,5,1486600,0,2738,1489338,82.7409080656577,79.94441640474214,85.3750707207125,25.0
West Bengal,33,Jhargram,1641868,710101,691203,2,1401306,0,5925,1407231,85.70914348778342,85.60951938900375,85.08265734437893,15.384615384615385
West Bengal,34,Medinipur,1674236,713838,693138,1,1406977,0,3344,1410321,84.2366906457632,84.16005357283913,83.9120660412649,6.25
West Bengal,35,Purulia,1645884,695989,656252,1,1352242,0,3619,1355861,82.37889182955786,82.54090049276273,81.75863057047106,11.11111111111111
West Bengal,36,Bankura,1648906,703940,663542,3,1367485,0,5160,1372645,83.24580054897004,83.65906500649483,82.17665810481783,33.33333333333333
West Bengal,37,Bishnupur,1627199,731565,686305,1,1417871,0,3320,1421191,87.33971690002268,87.8456024063834,86.3922226166469,12.5
West Bengal,38,Bardhaman Purba,1698089,731115,706739,10,1437864,0,1739,1439603,84.7778296661718,84.07399187450912,85.31013296154798,22.22222222222222
West Bengal,39,Bardhaman Durgapur,1733578,738241,693229,5,1431475,0,1714,1433189,82.67231125452676,83.7237654776027,81.38467914152852,18.51851851851852
West Bengal,40,Asansol,1615865,664991,572239,2,1237232,0,919,1238151,76.6246561439229,78.82000704055908,74.11097498115622,4.545454545454546
West Bengal,41,Bolpur,1705073,747330,711617,2,1458949,0,2980,1461929,85.73996538564624,85.65671523752651,85.47151137791295,8.333333333333332
West Bengal,42,Birbhum,1699219,743725,703397,1,1447123,0,2985,1450108,85.33967663967977,86.15197313473985,84.14554346122696,5.263157894736842
