STATE NAME,PC NO.,PC NAME,ELECTORS,MALE,FEMALE,OTHERS,TOTAL,NRI,POSTAL VOTES,TOTAL VOTES,VOTER TURN OUT %,MALE_TURNOUT,FEMALE_TURNOUT,OTHERS_TURNOUT
Andhra Pradesh,1.0,Adilabad ,1386282,518481,525482,2,1043965,0,11628,1055593,76.1456182796863,75.4864578010142,75.2174653637114,1.38888888888889
Andhra Pradesh,2.0,Peddapalle ,1425355,520741,500992,14,1021747,0,3447,1025194,71.9255203089757,71.7872331626217,71.6293287466955,12.0689655172414
Andhra Pradesh,3.0,Karimnagar ,1550810,550760,569382,0,1120142,0,7083,1127225,72.6862091423192,70.8662835732171,73.6350127837217,0.0
Andhra Pradesh,4.0,Nizamabad,1496193,467172,559329,4,1026505,0,7527,1034032,69.1108700548659,64.497477655089,72.4944818656543,4.76190476190476
Andhra Pradesh,5.0,Zahirabad,1445354,546010,546798,0,1092808,0,6976,1099784,76.0909784039066,76.0717067196837,75.1767374716436,0.0
Andhra Pradesh,6.0,Medak,1536166,605044,583040,0,1188084,0,5464,1193548,77.6965510237826,78.0326371952596,76.6636380251855,0.0
Andhra Pradesh,7.0,Malkajgiri,3183083,877156,741285,0,1618441,0,6418,1624859,51.0467053482426,50.9230409291541,50.796534280988,0.0
Andhra Pradesh,8.0,Secundrabad,1893741,546289,457397,3,1003689,0,1074,1004763,53.0570442314973,53.9652888430964,51.9346758773543,1.35135135135135
Andhra Pradesh,9.0,Hyderabad,1823217,525811,445415,0,971226,0,544,971770,53.2997443529761,54.762338713289,51.6519605398805,0.0
Andhra Pradesh,10.0,Chelvella,2185164,695012,617108,0,1312120,0,10192,1322312,60.5131697208997,60.2910750797433,59.8082980393677,0.0
Andhra Pradesh,11.0,Mahbubnagar,1418668,509912,499391,1,1009304,0,6216,1015520,71.5826394900005,71.5496254221806,70.8001525477314,0.636942675159236
Andhra Pradesh,12.0,Nagarkurnool,1477305,569056,537781,28,1106865,0,9294,1116159,75.553727903175,76.4280840867944,73.4614286553406,18.5430463576159
Andhra Pradesh,13.0,Nalgonda,1494343,597237,583448,2,1180687,0,10980,1191667,79.7452124445325,80.0854173650687,77.9813656709735,4.44444444444444
Andhra Pradesh,14.0,Bhongir ,1492240,620408,588076,9,1208493,0,4245,1212738,81.2696349112743,81.9927523782085,79.9947765264717,15.5172413793103
Andhra Pradesh,15.0,Warangal,1537777,590443,580206,74,1170723,0,5930,1176653,76.5164910126761,76.5371782341214,75.767163984199,47.4358974358974
Andhra Pradesh,16.0,Mahabubabad  ,1387288,560443,560406,4,1120853,0,5765,1126618,81.2101020119831,81.4589095750479,80.1943303616147,5.06329113924051
Andhra Pradesh,17.0,Khammam ,1440267,586887,592349,0,1179236,0,9639,1188875,82.5454585851096,82.4184574248471,81.3884213491251,0.0
Andhra Pradesh,18.0,Aruku ,1272340,450038,456802,24,906864,0,6974,913838,71.8234119810742,72.4091382270269,70.2735549217426,29.6296296296296
Andhra Pradesh,19.0,Srikakulam,1413726,503114,543763,0,1046877,0,7763,1054640,74.6000285769661,71.699812596641,77.0378230729671,0.0
Andhra Pradesh,20.0,Vizianagaram,1403736,554616,564891,0,1119507,0,6108,1125615,80.187086460702,79.3444330312819,80.3834961472511,0.0
Andhra Pradesh,21.0,Visakhapatnam,1723011,583232,576946,0,1160178,0,3404,1163582,67.5318961979929,66.8090136818086,68.0625715195772,0.0
Andhra Pradesh,22.0,Anakapalli,1401474,561825,582294,1,1144120,0,5206,1149326,82.0083711863367,81.6475563500022,81.7785005856429,1.5625
Andhra Pradesh,23.0,Kakinada,1418290,555263,538635,35,1093933,0,7797,1101730,77.6801641413251,78.3285135916715,75.9764440369561,25.5474452554745
Andhra Pradesh,24.0,Amalapuram ,1357865,565013,548900,1,1113914,0,8072,1121986,82.6286854731509,82.8028940777509,81.310688600357,1.96078431372549
Andhra Pradesh,25.0,Rajahmundry,1421276,575432,574132,11,1149575,0,7051,1156626,81.3794083626263,81.4105856171312,80.4256255016691,10.6796116504854
Andhra Pradesh,26.0,Narsapuram,1325028,536507,546670,0,1083177,0,5925,1089102,82.194640415146,82.2670446965666,81.337477551737,0.0
Andhra Pradesh,27.0,Eluru ,1427764,600526,594189,5,1194720,0,8516,1203236,84.2741517505694,84.9854660624775,82.4570776737293,6.75675675675676
Andhra Pradesh,28.0,Machilipatnam ,1369311,564406,569695,3,1134104,0,8944,1143048,83.4761423810953,83.5585125440069,82.1746988560062,2.85714285714286
Andhra Pradesh,29.0,Vijayawada,1564511,599506,589998,10,1189514,0,9471,1198985,76.636405880176,76.7597590830405,75.3422978201739,6.06060606060606
Andhra Pradesh,30.0,Guntur,1572016,613894,623668,17,1237579,0,9196,1246775,79.3105795360862,79.5780855443614,78.1375326216193,9.65909090909091
Andhra Pradesh,31.0,Narasaraopet,1514861,635270,640887,0,1276157,0,6674,1282831,84.6830831343602,84.947655705722,83.6602663763496,0.0
Andhra Pradesh,32.0,Bapatla ,1392964,583921,594010,1,1177932,0,8318,1186250,85.1601333559231,85.4814177195918,84.2530328453642,0.854700854700855
Andhra Pradesh,33.0,Ongole ,1470212,597957,599889,9,1197855,0,11049,1208904,82.2265088300191,81.755015374603,81.957759352086,8.57142857142857
Andhra Pradesh,34.0,0dyal,1576945,601303,599288,16,1200607,0,9073,1209680,76.7103481732083,76.8891321276816,75.5350136313621,6.83760683760684
Andhra Pradesh,35.0,Kurnool,1481791,543424,519253,3,1062680,0,5390,1068070,72.079665755832,73.5999826640013,69.9161146119459,1.94805194805195
Andhra Pradesh,36.0,A0tapur,1536894,612936,592912,1,1205849,0,6346,1212195,78.8730387391713,79.0982120388951,77.9005510344048,0.689655172413793
Andhra Pradesh,37.0,Hindupur,1446496,598591,572192,0,1170783,0,8487,1179270,81.5259772581466,81.5492408967554,80.4034561884969,0.0
Andhra Pradesh,38.0,Kadapa,1550440,583320,606195,1,1189516,0,11604,1201120,77.4696215267924,76.337596122136,77.1992807239625,0.884955752212389
Andhra Pradesh,39.0,Nellore,1606126,589353,590606,9,1179968,0,8893,1188861,74.0204068672072,74.0078961446019,73.0124822137417,4.76190476190476
Andhra Pradesh,40.0,Tirupati ,1574161,602087,605328,3,1207418,0,6945,1214363,77.1435069221001,77.3724663214965,76.1128777333922,1.77514792899408
Andhra Pradesh,41.0,Rajampet,1487791,570991,582836,8,1153835,0,7406,1161241,78.0513526429452,77.7195816960014,77.5278806452986,5.36912751677852
Andhra Pradesh,42.0,Chittoor ,1451851,595000,597153,0,1192153,0,6984,1199137,82.5936683585299,82.4541686471835,82.1135874856304,0.0
Andhra Pradesh,,,64934133,24264387,23899017,299,48163703,0,304018,48467721,74.64,74.34,74.12,5.38
Arunachal Pradesh,1.0,Arunachal West,446640,155623,170663,0,326286,0,11385,337671,75.6024986566362,71.2918594530212,75.1849192258724,0.0
Arunachal Pradesh,2.0,Arunachal East,312704,126888,128574,0,255462,0,7695,263157,84.1553034179288,79.4390534026169,84.3207722878766,0.0
Assam,1.0,Karimganj ,1165997,481673,404641,0,886314,0,1468,887782,76.1393039604733,78.46319500101,73.5247035052431,0.0
Assam,2.0,Silchar,1060175,428972,370918,0,799890,0,168,800058,75.464711014691,77.7433034905216,73.5341464188289,0.0
Assam,3.0,Autonomous District,702230,279451,263869,0,543320,0,397,543717,77.4271962177634,77.9587680633823,76.9017122040073,0.0
Assam,4.0,Dhubri,1550166,709038,660085,0,1369123,0,599,1369722,88.3596982516711,89.1730367262547,87.6907360025082,0.0
Assam,5.0,Kokrajhar,1505472,636473,587031,0,1223504,0,739,1224243,81.3195462951154,82.2379225289783,80.581335493037,0.0
Assam,6.0,Barpeta,1430188,634466,571414,0,1205880,0,1164,1207044,84.3975757033341,84.2380726039656,84.8119903464531,0.0
Assam,7.0,Gauhati,1922270,784535,727081,0,1511616,0,632,1512248,78.6699058925125,79.4766828145546,77.8656896878544,0.0
Assam,8.0,Mangaldoi,1515676,651247,581802,0,1233049,0,425,1233474,81.3811131138845,82.4741210529382,80.4134825497261,0.0
Assam,9.0,Tezpur,1259568,505481,475043,0,980524,0,322,980846,77.8716194758838,77.4865217437959,78.6819400713208,0.0
Assam,10.0,Nowgong,1523881,639499,590545,0,1230044,0,451,1230495,80.7474468150728,80.9358195033482,80.8429753423757,0.0
Assam,11.0,Kaliabor,1457219,605354,561208,0,1166562,0,829,1167391,80.110882441143,80.5926553130758,79.729050112659,0.0
Assam,12.0,Jorhat,1189486,483784,447088,0,930872,0,696,931568,78.3168528255062,79.2922140927805,77.3947845836392,0.0
Assam,13.0,Dibrugarh,1124305,462187,428637,0,890824,0,305,891129,79.2604320002135,79.9253985574288,78.7770577489276,0.0
Assam,14.0,Lakhimpur,1431080,572467,539555,0,1112022,0,648,1112670,77.750370349666,77.9656931175137,77.5865911826327,0.0
Bihar,1.0,Valmiki Nagar,1456598,484433,415396,9,899838,0,331,900169,61.7994120546644,61.6301096773291,61.9909833142066,18.0
Bihar,2.0,Paschim Champaran,1413148,469048,385593,0,854641,0,192,854833,60.4913993438762,61.0125485676526,59.9288487421863,0.0
Bihar,3.0,Purvi Champaran,1439253,442071,380577,0,822648,0,41,822689,57.1608327375382,56.7155428229797,57.7089117588635,0.0
Bihar,4.0,Sheohar,1485801,433327,409336,0,842663,0,263,842926,56.732092655746,54.7245441905048,59.0606815692917,0.0
Bihar,5.0,Sitamarhi,1574914,448849,451628,0,900477,0,114,900591,57.183503353199,54.0086972425842,60.871885833203,0.0
Bihar,6.0,Madhubani,1627832,413708,446640,0,860348,0,121,860469,52.8598160006684,47.1504557105426,59.5917278185457,0.0
Bihar,7.0,Jhanjharpur,1668405,450499,490640,0,941139,0,126,941265,56.4170570095391,50.3245690565211,63.499459017327,0.0
Bihar,8.0,Supaul,1525583,468476,502044,0,970520,0,24,970544,63.6179086945777,58.7801459729459,68.9561205555014,0.0
Bihar,9.0,Araria,1587332,492513,483291,0,975804,0,9,975813,61.4750411382118,58.4299428647356,64.9466830615413,0.0
Bihar,10.0,Kishanganj,1438990,471096,457126,0,928222,0,277,928499,64.5243538871014,61.7561117570949,67.6140876610939,0.0
Bihar,11.0,Katihar,1446478,495600,481934,0,977534,0,299,977833,67.6009590190794,64.5078994843013,71.1687299072169,0.0
Bihar,12.0,Purnia,1582626,511262,506106,0,1017368,0,382,1017750,64.3076759765099,61.8562862659885,66.9751820258264,0.0
Bihar,13.0,Madhepura,1725693,508782,525869,0,1034651,0,148,1034799,59.9642578372862,56.6527590802954,63.641259491082,0.0
Bihar,14.0,Darbhanga,1495445,407516,421741,0,829257,0,32,829289,55.4543296476968,51.1379151106292,60.4225586186542,0.0
Bihar,15.0,Muzaffarpur,1551363,490949,457916,0,948865,0,62,948927,61.1673090050491,59.2244054024059,63.6499223689898,0.0
Bihar,16.0,Vaishali,1566321,480759,445167,0,925926,0,25,925951,59.1162986386571,57.2200672940622,61.5147683697793,0.0
Bihar,17.0,Gopalganj (Sc),1654838,444922,458639,0,903561,0,29,903590,54.6029278998911,51.0929492001116,58.5905233479861,0.0
Bihar,18.0,Siwan,1563860,443827,440178,0,884005,0,39,884044,56.5296126251711,52.7982060646435,61.0159201014673,0.0
Bihar,19.0,Maharajganj,1642068,420232,426095,0,846327,0,506,846833,51.5711286012516,48.1699230279862,55.6378911411843,0.0
Bihar,20.0,Saran,1538740,450511,411954,0,862465,0,1127,863592,56.1233216787761,54.2503281432511,58.4266443902031,0.0
Bihar,21.0,Hajipur (Sc),1649547,478157,425876,0,904033,0,1671,905704,54.9062257698629,53.502777762237,56.511008258848,0.0
Bihar,22.0,Ujiarpur,1426217,433858,425047,0,858905,0,20,858925,60.224005182942,56.8890392439936,64.2699887804568,0.0
Bihar,23.0,Samastipur (Sc),1504451,430782,432401,0,863183,0,28,863211,57.3771428913271,53.7398001763957,61.6313161619343,0.0
Bihar,24.0,Begusarai,1778759,545214,532151,0,1077365,0,768,1078133,60.6115274750542,57.4612315274051,64.232285911894,0.0
Bihar,25.0,Khagaria,1506587,445941,450160,0,896101,0,209,896310,59.4927475147469,55.7859288272522,63.8279469877536,0.0
Bihar,26.0,Bhagalpur,1685339,522417,451535,1,973953,0,234,974187,57.8036228912996,58.5121551014465,57.2295684730712,1.78571428571429
Bihar,27.0,Banka,1549456,461297,438021,0,899318,0,42,899360,58.0435972367076,56.0088828018951,60.4962944343315,0.0
Bihar,28.0,Munger,1719984,505931,408329,8,914268,0,174,914442,53.165727123043,54.0879380277233,52.298444990631,17.0212765957447
Bihar,29.0,Nalanda,1951967,503039,418609,0,921648,0,193,921841,47.226259460329,48.6176925686418,45.7781350130683,0.0
Bihar,30.0,Patna Sahib,1946249,510480,369747,0,880227,0,2541,882768,45.3574028811319,48.5481120654156,41.3839533048671,0.0
Bihar,31.0,Pataliputra,1736074,553018,423797,0,976815,0,1980,978795,56.3797971745444,59.3632558773614,52.9217032967033,0.0
Bihar,32.0,Arrah,1824515,517499,375555,0,893054,0,297,893351,48.9637520108084,51.0833138377314,46.5168848284268,0.0
Bihar,33.0,Buxar,1640671,494435,394512,0,888947,0,205,889152,54.1944119204886,56.6622736649095,51.8942468196832,0.0
Bihar,34.0,Sasaram (Sc),1607747,448672,397016,0,845688,0,1920,847608,52.7202352111371,52.2863142781894,53.1003609876537,0.0
Bihar,35.0,Karakat,1580558,457406,332394,0,789800,0,561,790361,50.0051880411855,53.9726104984436,45.5818163118379,0.0
Bihar,36.0,Jahanabad,1423246,445501,365502,0,811003,0,849,811852,57.0422822196584,59.4584025678498,54.512588535864,0.0
Bihar,37.0,Aurangabad,1536153,429944,355719,0,785663,0,679,786342,51.1890417165478,52.1519736634619,50.1020438344819,0.0
Bihar,38.0,Gaya (Sc),1501521,442912,364010,0,806922,0,2665,809587,53.9177940235268,55.4913526543417,51.8751496357438,0.0
Bihar,39.0,Nawada,1694895,478247,406136,0,884383,0,91,884474,52.1845896058458,53.3185946769146,50.9817606668089,0.0
Bihar,40.0,Jamui (Sc),1550936,415589,360008,0,775597,0,53,775650,50.0117348491492,50.1980920354923,49.8429980450903,0.0
Goa,1.0,North Goa,515434,199489,205701,0,405190,0,1755,406945,78.9519123689939,78.0082744165676,79.2624046794262,0.0
Goa,2.0,South Goa,545316,195128,214329,0,409457,0,1038,410495,75.2765369070411,71.7353342328068,78.5966005977374,0.0
Gujarat,1.0,Kachchh,1533778,519100,423463,0,942563,4,4958,947521,61.7769325156574,64.4078227401428,58.2222979949706,0.0
Gujarat,2.0,Banaskantha,1515711,511698,371518,0,883216,0,4150,887366,58.5445378439557,64.2966730708095,51.6324945138789,0.0
Gujarat,3.0,Patan,1628641,525799,423880,0,949679,0,6937,956616,58.7370697409681,62.1948507580973,54.1901898216331,0.0
Gujarat,4.0,Mahesana,1498219,541116,456612,7,997735,0,6560,1004295,67.0325900285606,69.6554147727931,63.4145460757205,30.4347826086957
Gujarat,5.0,Sabarkantha,1615840,583583,502387,0,1085970,0,9893,1095863,67.8200193088425,70.2429084011088,64.2967299198702,0.0
Gujarat,6.0,Gandhinagar,1733972,617164,511490,2,1128656,0,8358,1137014,65.5728004835141,68.5721777602967,61.4005603585911,11.1111111111111
Gujarat,7.0,Ahmedabad East,1601832,557279,422980,6,980265,0,6261,986526,61.5873574756903,65.5134470447302,56.5012957174534,60.0
Gujarat,8.0,Ahmedabad West,1534400,531702,428771,2,960475,0,5085,965560,62.9275286757039,66.4654086163447,58.4765341581701,40.0
Gujarat,9.0,Surendranagar,1656657,539246,399328,1,938575,0,6864,945439,57.0690855137787,61.5211729097192,51.2955950282857,50.0
Gujarat,10.0,Rajkot,1655717,590854,461740,1,1052595,0,5188,1057783,63.8867028604526,68.3574764652187,58.3851340073743,12.5
Gujarat,11.0,Porbandar,1539223,468592,335821,2,804415,0,5570,809985,52.622979256417,58.1318347320692,45.9159508984361,28.5714285714286
Gujarat,12.0,Jamnagar,1470952,484080,364974,1,849055,0,3934,852989,57.9889078637508,62.9084638186664,52.1845434099095,8.33333333333333
Gujarat,13.0,Junagadh,1485543,513928,423553,0,937481,0,4776,942257,63.4284567999715,66.6315743072068,59.3784478299087,0.0
Gujarat,14.0,Amreli,1486286,455668,349837,0,805505,0,4110,809615,54.4723559261138,58.6106612781031,49.3709329385582,0.0
Gujarat,15.0,Bhavnagar,1594531,516968,396013,11,912992,0,5152,918144,57.5808184350132,61.995937036051,52.1187689845597,45.8333333333333
Gujarat,16.0,A0d,1496859,539236,427943,0,967179,0,4083,971262,64.8866726926184,69.0585383158372,59.7978897476277,0.0
Gujarat,17.0,Kheda,1599471,540239,411083,1,951323,0,6141,957464,59.8612916395483,64.8831299226311,53.6631055135214,5.88235294117647
Gujarat,18.0,Panchmahal,1576667,512435,414555,0,926990,0,8026,935016,59.3033278428482,62.5576060775862,54.831763549717,0.0
Gujarat,19.0,Dahod,1411765,466791,428519,1,895311,0,6124,901435,63.8516325309099,65.5787705007853,61.2682027122667,25.0
Gujarat,20.0,Vadodara,1638321,621926,533715,15,1155656,0,6512,1162168,70.9365258700829,73.2946074913173,67.642772046336,57.6923076923077
Gujarat,21.0,Chhota Udaipur,1536305,590131,504411,0,1094542,0,7081,1101623,71.7060088979727,73.9641366102617,68.3463365590728,0.0
Gujarat,22.0,Bharuch,1417548,562549,493760,10,1056319,0,4741,1061060,74.8517863239904,76.5693651217109,72.3373084473615,35.7142857142857
Gujarat,23.0,Bardoli,1614106,636398,567973,0,1204371,0,5238,1209609,74.9398738372821,76.7181779496026,72.407669458574,0.0
Gujarat,24.0,Surat,1484068,538576,407928,3,946507,0,1876,948383,63.9042820140317,67.0044825085128,59.9715966727531,11.1111111111111
Gujarat,25.0,Navsari,1764620,644265,512736,13,1157014,0,4462,1161476,65.820176581927,66.2879996049049,64.7033659288199,25.0
Gujarat,26.0,Valsad,1512061,580599,538185,0,1118784,0,4398,1123182,74.2815270018868,74.916676666757,73.0271138695679,0.0
Haryana,1.0,Ambala,1692424,667712,551882,0,1219594,0,531,1220125,72.093340675859,73.7811467530028,70.7186525728769,0.0
Haryana,2.0,Kurukshetra,1498459,618481,517170,0,1135651,0,522,1136173,75.8227619174098,76.9153569305539,75.0416801489313,0.0
Haryana,3.0,Sirsa,1660556,692765,586098,0,1278863,0,408,1279271,77.0387147437364,78.2946323424704,75.7470368604097,0.0
Haryana,4.0,Hisar,1517606,637448,518049,0,1155497,0,1308,1156805,76.2256475000758,77.6757992425535,75.1404398635996,0.0
Haryana,5.0,Karnal,1684321,666729,526629,0,1193358,0,339,1193697,70.8711106730843,73.295274655691,68.4180782152517,0.0
Haryana,6.0,Sonipat,1417187,551189,434412,0,985601,0,920,986521,69.6112086831166,71.3080343454912,68.2160366070054,0.0
Haryana,7.0,Rohtak,1567508,578206,465772,0,1043978,0,1745,1045723,66.7124505903638,69.4676922115775,65.6534731619305,0.0
Haryana,8.0,Bhiwani-Mahendragarh,1473912,559428,470289,0,1029717,0,1640,1031357,69.974123285515,72.0948604375735,69.8108250131371,0.0
Haryana,9.0,Gurgaon,1844906,727100,593187,0,1320287,0,360,1320647,71.5834302669079,74.5796369178947,69.3080724876442,0.0
Haryana,10.0,Faridabad,1740351,651241,479430,0,1130671,0,261,1130932,64.982983317733,67.3644391529083,62.2976168819356,0.0
Himachal Pradesh,1.0,Kangra,1258599,389575,408414,0,797989,0,1937,799926,63.5568596510882,62.0523177932423,67.3898229015241,0.0
Himachal Pradesh,2.0,Mandi,1150408,377093,347977,0,725070,0,1412,726482,63.1499433244553,65.0456414643907,62.0553077736544,0.0
Himachal Pradesh,3.0,Hamirpur,1247699,394620,438467,0,833087,0,2657,835744,66.9828219786984,64.1650189916229,71.900463247653,0.0
Himachal Pradesh,4.0,Shimla,1153363,403062,333715,0,736777,0,1270,738047,63.9908684429794,67.0857633618279,61.3208847303711,0.0
Jammu & Kashmir,1.0,Baramulla,1190766,256288,209691,0,465979,0,60,466039,39.1377483065523,41.1620347171363,37.017794725135,0.0
Jammu & Kashmir,2.0,Srinagar,1207230,178779,133429,0,312208,0,37,312245,25.8645825567622,28.3190480640833,23.1790829054068,0.0
Jammu & Kashmir,3.0,A0tnag,1301143,211595,163643,0,375238,0,43,375281,28.8424100963537,30.9489228320981,26.5684843545279,0.0
Jammu & Kashmir,4.0,Ladakh,166763,57162,60002,0,117164,0,1904,119068,71.3995310710409,69.7863508729093,75.2564906559639,0.0
Jammu & Kashmir,5.0,Udhampur,1469072,556791,484338,1,1041130,0,1245,1042375,70.9546570896457,71.6038729473675,71.452091170613,100.0
Jammu & Kashmir,6.0,Jammu,1848155,665098,587601,0,1252699,0,3830,1256529,67.988291025374,70.2232771172366,68.0631795736676,0.0
Karnataka,1.0,Chikkodi,1442206,564052,506614,2,1070668,0,827,1071495,74.2955583321661,76.1196587886484,72.9528828984506,3.17460317460317
Karnataka,2.0,Belgaum,1580895,569642,508074,0,1077716,0,1266,1078982,68.2513386404537,70.9286283494372,65.8355491284539,0.0
Karnataka,3.0,Bagalkot,1568633,561494,517311,0,1078805,0,519,1079324,68.8066615964346,70.9747471300109,66.7884144641031,0.0
Karnataka,4.0,Bijapur,1622635,521090,445637,7,966734,0,63,966797,59.5819146018667,61.5252558288358,57.5431279376065,3.95480225988701
Karnataka,5.0,Gulbarga,1721990,522778,474347,0,997125,0,961,998086,57.9611960580491,59.5362852942148,56.2450347302095,0.0
Karnataka,6.0,Raichur,1661606,501122,467391,0,968513,0,534,969047,58.3199025521092,59.9578124196121,56.6355371209835,0.0
Karnataka,7.0,Bidar,1600962,508036,454615,1,962652,0,554,963206,60.164201273984,60.5971256573666,59.7058147552287,1.42857142857143
Karnataka,8.0,Koppal,1535105,526117,480597,2,1006716,0,714,1007430,65.6261298087102,68.318099361251,62.8533726027684,2.10526315789474
Karnataka,9.0,Bellary,1487945,541905,503534,9,1045448,0,465,1045913,70.2924503257849,72.1974934284766,68.3294410119945,5.88235294117647
Karnataka,10.0,Haveri,1558749,594946,520512,0,1115458,0,910,1116368,71.619484599509,73.7836071429014,69.2723839132072,0.0
Karnataka,11.0,Dharwad,1578125,562867,477563,0,1040430,0,1040,1041470,65.9941386138614,69.6640853097814,62.0951184722585,0.0
Karnataka,12.0,Uttara Kannada,1450599,521220,479217,0,1000437,0,1033,1001470,69.0383765603037,70.4799946993289,67.8070736456046,0.0
Karnataka,13.0,Davanagere,1522712,581109,533385,0,1114494,0,638,1115132,73.2332837726372,75.2906438150815,71.0790486813226,0.0
Karnataka,14.0,Shimoga,1562243,572307,556790,10,1129107,0,1257,1130364,72.3551969827997,73.5578128032471,71.0944891843268,12.1951219512195
Karnataka,15.0,Udupi Chikmagalur,1387294,510562,522488,1,1033051,0,1283,1034334,74.5576640567897,75.2253539803451,73.8245380032017,1.61290322580645
Karnataka,16.0,Hassan,1561486,585749,560755,4,1146508,0,1026,1147534,73.4898679847274,74.3044922739687,72.7065391866276,4.54545454545455
Karnataka,17.0,Dakshina Kannada,1565219,595446,611674,0,1207120,0,463,1207583,77.1510568169694,76.9680001240907,77.3794855316856,0.0
Karnataka,18.0,Chitradurga,1661277,572567,524303,1,1096871,0,795,1097666,66.0736289011405,67.7915791991229,64.234949346199,1.0989010989011
Karnataka,19.0,Tumkur,1518518,565126,535597,12,1100735,0,1277,1102012,72.5715467317477,73.9442074686625,71.0561367851561,10.1694915254237
Karnataka,20.0,Mandya,1669262,604491,587306,8,1191805,0,1236,1193041,71.4711651017036,72.0830953383186,70.7603558102297,8.98876404494382
Karnataka,21.0,Mysore,1723134,596311,561022,13,1157346,0,2282,1159628,67.2976100523813,68.8270076674388,65.6423276956468,9.21985815602837
Karnataka,22.0,Chamarajanagar,1555781,585063,547426,8,1132497,0,829,1133326,72.8461139453432,74.1364038972542,71.4368113082468,13.1147540983607
Karnataka,23.0,Bangalore Rural,2190398,758651,696340,12,1455003,0,607,1455610,66.4541329931821,66.8022992675663,66.051874729661,4.59770114942529
Karnataka,24.0,Bangalore North,2401472,720898,634569,18,1355485,0,2068,1357553,56.5300365775658,57.2493853357306,55.6366658805025,4.93150684931507
Karnataka,25.0,Bangalore Central,1931456,573657,500273,27,1073957,0,645,1074602,55.6368874051493,56.8077344324049,54.3506791213901,9.03010033444816
Karnataka,26.0,Bangalore South,1998724,596688,516207,19,1112914,0,1445,1114359,55.7535207462361,56.7958392665413,54.4749705573214,5.9375
Karnataka,27.0,Chikkballapur,1658410,652727,608718,6,1261451,0,2460,1263911,76.2122153146689,77.3804132633101,74.7454530273039,5.0
Karnataka,28.0,Kolar,1492977,581924,544042,7,1125973,0,1367,1127340,75.5095356458941,77.2004675085535,73.8260661886436,4.9645390070922
Kerala,1.0,Kasaragod,1242829,459280,514333,0,973613,0,1582,975195,78.465742270256,77.4949464952806,79.3962689389554,0.0
Kerala,2.0,Kannur,1168593,438891,506993,0,945884,0,2688,948572,81.1721446217802,80.7825893292644,81.8076348392385,0.0
Kerala,3.0,Vadakara,1179031,436972,520810,0,957782,0,2482,960264,81.4451867677779,78.2373447014526,83.9519187835588,0.0
Kerala,4.0,Wayanad,1249123,454055,460171,0,914226,0,912,915138,73.2624409285555,74.033402303236,72.5804594528521,0.0
Kerala,5.0,Kozhikode,1181909,456299,484028,0,940327,0,2900,943227,79.8053826479027,80.2505482832184,79.3975322574825,0.0
Kerala,6.0,Malappuram,1197664,415672,437264,0,852936,0,532,853468,71.261054853448,69.5467694629463,72.8735681989764,0.0
Kerala,7.0,Pon0i,1179083,405012,466307,0,871319,0,276,871595,73.9214287713418,70.6068171041254,76.8956902451292,0.0
Kerala,8.0,Palakkad,1208529,444249,465167,0,909416,0,1060,910476,75.3375384454986,75.897575201554,74.9699824810507,0.0
Kerala,9.0,Alathur ,1216207,452923,474384,0,927307,0,1349,928656,76.3567386143971,76.7650488464641,76.0817232514166,0.0
Kerala,10.0,Thrissur,1274931,433933,485624,0,919557,0,1110,920667,72.2130844728068,71.6387331523928,72.6593721618835,0.0
Kerala,11.0,Chalakudy,1150143,437197,446915,0,884112,0,925,885037,76.9501705440106,77.4711828966837,76.3906337868074,0.0
Kerala,12.0,Ernakulam,1156355,428604,421361,0,849965,0,945,850910,73.585533854223,75.8560270997818,71.3935224798583,0.0
Kerala,13.0,Idukki,1158618,424879,394103,0,818982,0,1285,820267,70.7970185168882,73.5154729256244,68.0104715655922,0.0
Kerala,14.0,Kottayam,1161267,426604,404356,0,830960,0,1461,832421,71.6821368384704,74.5860739000143,68.8787251620376,0.0
Kerala,15.0,Alappuzha,1271149,477034,517975,0,995009,0,3647,998656,78.5632526163337,78.8603263295366,78.8599468050284,0.0
Kerala,16.0,Mavelikkara ,1252369,416193,470987,0,887180,0,2089,889269,71.0069476328462,71.0454889964699,71.6410668272931,0.0
Kerala,17.0,Pathanamthitta,1323320,425887,444099,0,869986,0,1265,871251,65.838270410785,67.9025769966024,64.3017861486604,0.0
Kerala,18.0,Kollam,1219202,406898,469024,0,875922,0,3306,879228,72.1150391813662,71.0665625725908,73.0083667354166,0.0
Kerala,19.0,Attingal,1251111,394491,462016,0,856507,0,2858,859365,68.6881499723046,68.9320099949326,68.5215286593975,0.0
Kerala,20.0,Thiruva0thapuram,1272632,433243,437404,0,870647,0,2815,873462,68.6342949100761,70.9401751386897,66.6023083716539,0.0
Madhya Pradesh,1.0,Morena,1702457,538721,315516,1,854238,0,43,854281,50.1792996827526,57.4976119195897,41.321920068731,2.85714285714286
Madhya Pradesh,2.0,Bhind,1600137,469662,259501,0,729163,0,204,729367,45.5815345811015,52.7320250870705,36.6904623545996,0.0
Madhya Pradesh,3.0,Gwalior,1876963,594606,395609,15,990230,0,841,991071,52.8018399936493,58.2051726315109,46.4344527350045,12.5
Madhya Pradesh,4.0,Guna,1605613,580802,394613,0,975415,0,2204,977619,60.887586236534,67.7525547104661,52.7384042146567,0.0
Madhya Pradesh,5.0,Sagar,1520322,536897,354866,9,891772,0,228,892000,58.6717813726303,65.8910000417267,50.3769762684531,15.7894736842105
Madhya Pradesh,6.0,Tikamgarh,1528863,466852,299542,4,766398,0,480,766878,50.1600208782605,56.9093659603361,42.3073555042697,15.3846153846154
Madhya Pradesh,7.0,Damoh,1651614,558821,354514,1,913336,0,532,913868,55.3318148187167,63.3167531555213,46.1217018431039,2.77777777777778
Madhya Pradesh,8.0,Khajuraho,1702833,517233,357041,9,874283,0,248,874531,51.3574143794488,57.0286150273824,44.8923524537706,42.8571428571429
Madhya Pradesh,9.0,Satna,1458381,499873,413407,0,913280,0,171,913451,62.6345927435972,64.8783805356941,60.3122939291904,0.0
Madhya Pradesh,10.0,Rewa,1544719,457628,372259,0,829887,0,305,830192,53.7438848101176,55.8524297249534,51.5762055516685,0.0
Madhya Pradesh,11.0,Sidhi,1736048,547499,441120,0,988619,0,957,989576,57.0016497239708,59.8313136357725,53.7911860107797,0.0
Madhya Pradesh,12.0,Shahdol,1561016,527809,440179,0,967988,0,1128,969116,62.0823873682269,65.4473918828266,58.3671017667432,0.0
Madhya Pradesh,13.0,Jabalpur,1711621,558905,443227,0,1002132,0,78,1002210,58.5532661728268,62.2940130739352,54.4842261055986,0.0
Madhya Pradesh,14.0,Mandla,1824702,641219,575693,2,1216914,0,1747,1218661,66.7868506747951,69.2589768293895,64.0825190736029,9.09090909090909
Madhya Pradesh,15.0,Balaghat,1629739,570388,540968,0,1111356,0,2025,1113381,68.3165218479769,69.3583729136723,67.0338671163943,0.0
Madhya Pradesh,16.0,Chhindwara,1402038,584697,522618,0,1107315,0,316,1107631,79.0014963931078,81.0821267561297,76.8914332122475,0.0
Madhya Pradesh,17.0,Hoshangabad,1568206,593375,436990,0,1030365,0,1458,1031823,65.7963940961838,71.0955696991191,59.6724902159456,0.0
Madhya Pradesh,18.0,Vidisha,1634039,619102,453345,0,1072447,0,1334,1073781,65.7133030484584,71.0207406047814,59.5100263062552,0.0
Madhya Pradesh,19.0,Bhopal,1957241,639634,490428,7,1130069,0,212,1130281,57.7486880767366,61.6281254426034,53.4573624483469,10.4477611940299
Madhya Pradesh,20.0,Rajgarh,1578757,597753,412196,3,1009952,0,859,1010811,64.0257493711825,72.2979567992395,54.8379457788208,15.7894736842105
Madhya Pradesh,21.0,Dewas,1617111,653540,489442,0,1142982,0,1169,1144151,70.7527807305745,77.5567844682316,63.2746406039921,0.0
Madhya Pradesh,22.0,Ujjain,1525481,571019,444831,7,1015857,0,558,1016415,66.6291484456378,72.2134259388065,60.5606094848078,21.875
Madhya Pradesh,23.0,Mandsour,1626556,639978,520386,10,1160374,0,1225,1161599,71.4146331266799,76.4338102250456,66.0157939805271,31.25
Madhya Pradesh,24.0,Ratlam,1702576,569214,511452,0,1080666,0,2465,1083131,63.6171894822904,66.1293114565169,60.7739874804531,0.0
Madhya Pradesh,25.0,Dhar,1668441,586698,489232,0,1075930,0,1122,1077052,64.5543953906671,68.4460123966219,60.409378893415,0.0
Madhya Pradesh,26.0,Indore,2115302,736204,579670,22,1315896,0,1120,1317016,62.261369771314,66.588157828091,57.483506229107,30.1369863013699
Madhya Pradesh,27.0,Khargone,1703272,613926,537792,4,1151722,0,952,1152674,67.6741002024339,70.8269640988605,64.3050337552642,15.3846153846154
Madhya Pradesh,28.0,Khandwa,1759417,677300,578287,9,1255596,0,2115,1257711,71.4845315237945,74.2282367588136,68.3108657235468,20.9302325581395
Madhya Pradesh,29.0,Betul,1607831,573928,473282,21,1047231,0,596,1047827,65.1702200044656,68.6535634353577,61.4052250269866,67.741935483871
Maharashtra,1.0,0durbar ,1672943,583431,530953,0,1114384,0,2640,1117024,66.7699975432516,68.5050742020593,64.7244760632332,0.0
Maharashtra,2.0,Dhule,1675367,540775,438455,0,979230,0,3886,983116,58.6806353473597,61.6794277964895,55.1332639224207,0.0
Maharashtra,3.0,Jalgaon,1707969,550503,439312,6,989821,0,783,990604,57.9989449457221,60.8064851060822,55.0737137699328,24.0
Maharashtra,4.0,Raver,1593389,555229,455617,0,1010846,0,571,1011417,63.4758367228593,65.9893367182003,60.7430210126214,0.0
Maharashtra,5.0,Buldhana,1595435,535827,442565,0,978392,0,484,978876,61.3548029220871,63.6236585441152,59.0408636176261,0.0
Maharashtra,6.0,Akola,1672643,543956,433633,0,977589,0,1041,978630,58.5080020064054,61.8015940193032,54.9127743530258,0.0
Maharashtra,7.0,Amravati ,1612739,554649,446414,0,1001063,0,3479,1004542,62.2879461586779,65.5277316364891,58.4457632732791,0.0
Maharashtra,8.0,Wardha,1564552,553504,458674,0,1012178,0,1430,1013608,64.7858300650921,67.8154990682328,61.4426924328908,0.0
Maharashtra,9.0,Ramtek ,1677266,576271,473007,0,1049278,0,1362,1050640,62.6400344369945,65.0571465987501,59.9038007322593,0.0
Maharashtra,10.0,Nagpur ,1900784,578754,504850,0,1083604,0,2161,1085765,57.1219559928956,59.0818514057045,54.8880657460852,0.0
Maharashtra,11.0,Bhandara - Gondiya,1655852,615597,580693,1,1196291,0,1107,1197398,72.3131052775248,73.4035018267497,71.3667004639445,33.3333333333333
Maharashtra,12.0,Gadchiroli-Chimur,1468437,537674,489980,0,1027654,0,808,1028462,70.0378701980405,71.4808566418459,68.4754233071905,0.0
Maharashtra,13.0,Chandrapur,1753690,602269,506480,0,1108749,0,1139,1109888,63.2887226362698,65.4443884226037,60.8502064663557,0.0
Maharashtra,14.0,Yavatmal-Washim,1755292,564176,467163,0,1031339,0,2063,1033402,58.8735093648236,61.2890364871045,56.0338964754143,0.0
Maharashtra,15.0,Hingoli ,1586194,575663,473420,2,1049085,0,2392,1051477,66.2893063521864,68.6178987770282,63.4257572184948,20.0
Maharashtra,16.0,0ded,1687057,548032,462233,0,1010265,0,3755,1014020,60.105852973551,62.4295999270938,57.1784652228341,0.0
Maharashtra,17.0,Parbhani,1803792,637677,523946,1,1161624,0,747,1162371,64.4404121983022,67.4623426580085,61.0909591219718,9.09090909090909
Maharashtra,18.0,Jalna,1612056,595979,469547,0,1065526,0,849,1066375,66.1499972705663,68.9243262872303,63.0548811275958,0.0
Maharashtra,19.0,Aurangabad,1589395,554458,428022,0,982480,0,577,983057,61.8510187838769,65.6723665991929,57.6385307239324,0.0
Maharashtra,20.0,Dindori ,1530208,546617,422882,0,969499,0,817,970316,63.410725862105,67.8959011577717,58.6069549695381,0.0
Maharashtra,21.0,Nashik,1593774,523318,412087,0,935405,0,2195,937600,58.8289180272736,61.7377280872816,55.5335893807695,0.0
Maharashtra,22.0,Palghar ,1578149,531904,460337,39,992280,0,490,992770,62.9072413314586,64.0673744257588,61.57489583403,50.0
Maharashtra,23.0,Bhiwandi,1696584,502705,372339,0,875044,0,770,875814,51.6222008459351,53.184983934634,49.5800848219339,0.0
Maharashtra,24.0,Kalyan,1922034,472077,352517,58,824652,0,762,825414,42.9448178336075,45.1954191574344,40.1999064898336,60.4166666666667
Maharashtra,25.0,Thane,2073251,590956,462684,18,1053658,0,917,1054575,50.8657658913465,51.7885467805457,49.6796534007634,38.2978723404255
Maharashtra,26.0,Mumbai North,1783870,527247,418394,1,945642,0,1075,946717,53.0709636913004,54.2104456848857,51.5872810375801,14.2857142857143
Maharashtra,27.0,Mumbai North West,1775416,504202,393043,0,897245,0,626,897871,50.5724292222217,51.1074417694741,49.8384548472422,0.0
Maharashtra,28.0,Mumbai North East,1668357,485677,375903,58,861638,0,884,862522,51.6988869888159,52.6361022513105,50.4479078175515,66.6666666666667
Maharashtra,29.0,Mumbai North Central,1737084,472010,372857,0,844867,0,588,845455,48.6709335875525,48.7961460131705,48.4530656693376,0.0
Maharashtra,30.0,Mumbai South Central,1447886,424310,343790,30,768130,0,620,768750,53.0946497168976,53.4663471110204,52.5730661479551,50.8474576271186
Maharashtra,31.0,Mumbai   South,1485844,436292,342366,8,778666,0,1193,779859,52.485927190203,52.6513830443267,52.1344666802701,53.3333333333333
Maharashtra,32.0,Raigad,1532781,485550,502232,0,987782,0,410,988192,64.4705277531493,64.7078186448606,64.4420065310417,0.0
Maharashtra,33.0,Maval,1953741,646904,527044,1,1173949,0,431,1174380,60.1092980082826,62.508297831017,57.4567012141212,10.0
Maharashtra,34.0,Pune,1835835,533792,459588,2,993382,0,584,993966,54.1424474421721,56.299690125574,51.8921482284398,25.0
Maharashtra,35.0,Baramati,1813553,602117,463496,0,1065613,0,1350,1066963,58.8327443421836,62.866620239327,54.3861295985131,0.0
Maharashtra,36.0,Shirur,1824112,613290,475412,0,1088702,0,871,1089573,59.7316941065022,63.1902042767679,55.9410903648199,0.0
Maharashtra,37.0,Ahmadnagar ,1705005,594749,465801,1,1060551,0,2229,1062780,62.3329550353225,66.3814964127703,58.2799081136268,1.63934426229508
Maharashtra,38.0,Shirdi,1462267,519824,412130,0,931954,0,939,932893,63.7977195683141,67.8608121250889,59.4613233762224,0.0
Maharashtra,39.0,Beed,1792652,680369,551091,0,1231460,0,930,1232390,68.7467506242149,70.8960675064684,66.5942025482879,0.0
Maharashtra,40.0,Osmanabad,1759186,611537,505020,15,1116572,0,3132,1119704,63.6489831092335,65.7659304697759,61.3865020682178,93.75
Maharashtra,41.0,Latur ,1686957,576599,477934,0,1054533,0,3046,1057579,62.6915208864245,64.2155355981432,60.9075199314887,0.0
Maharashtra,42.0,Solapur ,1702739,526695,423356,0,950051,0,1459,951510,55.8811420893044,59.0496360234228,52.3846526959741,0.0
Maharashtra,43.0,Madha,1727322,594868,483305,0,1078173,0,1994,1080167,62.5342003401798,65.5489649229711,59.4858154937222,0.0
Maharashtra,44.0,Sangli,1649107,556695,486169,5,1042869,0,4641,1047510,63.5198322486048,65.252402592303,61.9655102092839,15.625
Maharashtra,45.0,Satara,1719998,519148,456561,0,975709,0,993,976702,56.7850660291466,59.3591496796206,54.8293192585521,0.0
Maharashtra,46.0,Ratnagiri - Sindhudurg,1367362,444269,451748,0,896017,0,392,896409,65.5575480377545,66.957191429846,64.4950730828425,0.0
Maharashtra,47.0,Kolhapur,1758293,663565,595421,0,1258986,0,2032,1261018,71.7183086095435,73.5699611176217,70.4252689348465,0.0
Maharashtra,48.0,Hatka0gle,1630604,630470,556249,8,1186727,0,3605,1190332,72.9994529634418,74.4676578836714,71.473415054095,21.6216216216216
Manipur,1.0,Inner Manipur,855360,307043,334205,0,641248,0,66,641314,74.9759165731388,73.9299713952749,76.3417280566501,0.0
Manipur,2.0,Outer Manipur,919009,379493,393746,0,773239,0,578,773817,84.2012428605161,84.5889281192603,85.0292935640539,0.0
Meghalaya,1.0,Shillong,980740,292971,326895,0,619866,0,175,620041,63.2217509227726,61.0937913805436,65.3818768025793,0.0
Meghalaya,2.0,Tura ,586501,232357,225763,0,458120,0,134,458254,78.133541119282,78.2109798377596,78.0622318115965,0.0
Mizoram,1.0,Mizoram,702170,212673,213477,0,426150,0,8812,434962,61.9453978381304,62.093218804926,60.0732775965849,0.0
Nagaland,1.0,Nagaland,1182972,528703,510521,0,1039224,0,738,1039962,87.9109564723425,88.7381860721952,87.7492931358984,0.0
Odisha,1.0,Bargarh,1430717,595871,526985,8,1122864,0,3289,1126153,78.7124917087027,79.3923042076372,77.5790239191624,8.69565217391304
Odisha,2.0,Sundargarh ,1410532,515013,493933,0,1008946,0,1777,1010723,71.6554463138731,71.7543138579858,71.4307613324946,0.0
Odisha,3.0,Sambalpur,1297098,504240,476826,2,981068,0,3629,984697,75.9153895850583,75.4906804401527,75.9754941404227,2.5
Odisha,4.0,Keonjhar ,1346683,550293,532437,0,1082730,0,1841,1084571,80.5364736912844,79.709057514952,81.3012487517064,0.0
Odisha,5.0,Mayurbhanj ,1327555,522251,528655,0,1050906,0,3649,1054555,79.4358802460162,78.0626742300247,80.4647474436912,0.0
Odisha,6.0,Balasore,1366218,531346,516773,0,1048119,0,1742,1049861,76.8443249905945,75.0794108337855,78.7630446677468,0.0
Odisha,7.0,Bhadrak ,1469498,537329,541995,0,1079324,0,2647,1081971,73.6286133087626,69.583634418795,78.120000345922,0.0
Odisha,8.0,Jajpur ,1303733,522476,456676,0,979152,0,2628,981780,75.3052964065495,75.2579413378812,75.298563695512,0.0
Odisha,9.0,Dhenkanal,1363471,551212,488983,5,1040200,0,1911,1042111,76.4307418346265,76.645470965876,76.4174444117996,9.25925925925926
Odisha,10.0,Bolangir,1563025,605683,563394,40,1169117,0,1844,1170961,74.9163321124102,74.3505042767777,75.3327432161033,49.3827160493827
Odisha,11.0,Kalahandi,1474135,576088,539704,11,1115803,0,2028,1117831,75.8296221173773,76.7702773835462,74.6154505512129,22.4489795918367
Odisha,12.0,Nabarangpur ,1297210,512473,509104,0,1021577,0,610,1022187,78.7988837582196,79.3589318731553,78.1735989976169,0.0
Odisha,13.0,Kandhamal,1143602,422515,416406,0,838921,0,875,839796,73.4342892020126,72.7157731692625,74.2718732330808,0.0
Odisha,14.0,Cuttack,1371617,522746,455864,0,978610,0,1946,980556,71.4890527020298,71.6364199468016,71.3779745781023,0.0
Odisha,15.0,Kendrapara ,1555444,577477,558439,0,1135916,0,1691,1137607,73.137123548003,69.9420215078768,76.9809422062929,0.0
Odisha,16.0,Jagatsinghpur ,1499673,587440,544083,3,1131526,0,1342,1132868,75.5410012716105,73.7991803999508,77.6545896994912,4.28571428571429
Odisha,17.0,Puri,1404581,568551,469388,0,1037939,0,1548,1039487,74.0069102458313,76.6908926100082,71.0221151634731,0.0
Odisha,18.0,Bhubaneswar,1527768,485138,406314,8,891460,0,498,891958,58.3830791062517,58.1280658325765,58.7950823942072,3.16205533596838
Odisha,19.0,Aska,1408780,449644,446046,0,895690,0,771,896461,63.6338534050739,59.9801241904609,67.8769636256561,0.0
Odisha,20.0,Berhampur,1334268,450468,454066,0,904534,0,1399,905933,67.8973789373649,66.5038768387672,69.5574247885624,0.0
Odisha,21.0,Koraput ,1300437,485037,504205,1,989243,0,1414,990657,76.1787768265591,77.1139944068796,75.1521809119527,0.666666666666667
Punjab,1.0,Gurdaspur,1500337,532763,509586,0,1042349,0,399,1042748,69.5009187935777,68.7110748845385,71.4925461080667,0.0
Punjab,2.0,Amritsar,1477260,537622,469488,0,1007110,0,176,1007286,68.1861012956419,69.3580514487705,67.3775333595483,0.0
Punjab,3.0,Khadoor Sahib,1563394,534962,505352,0,1040314,0,308,1040622,66.561724043971,66.0381690697215,67.9294993117688,0.0
Punjab,4.0,Jalandhar,1551484,532265,508444,0,1040709,0,69,1040778,67.0827414269177,65.9914997656732,68.5397999253191,0.0
Punjab,5.0,Hoshiarpur,1485243,473084,487516,0,960600,0,962,961562,64.7410558406941,62.7710418142785,67.7080165049366,0.0
Punjab,6.0,A0dpur Sahib,1564708,554688,532346,0,1087034,0,453,1087487,69.5009548107379,68.3390191346001,71.4084888677843,0.0
Punjab,7.0,Ludhiana,1561173,601709,499984,0,1101693,0,274,1101967,70.5858351380661,72.0917805576756,68.9452419365959,0.0
Punjab,8.0,Fatehgarh Sahib,1396940,551095,479741,0,1030836,0,194,1031030,73.8063195269661,74.6981076578793,73.1724094803327,0.0
Punjab,9.0,Faridkot,1455055,547017,484634,0,1031651,0,694,1032345,70.9488644759133,71.5463604699678,70.6629398444825,0.0
Punjab,10.0,Firozpur,1522107,590404,514569,0,1104973,0,675,1105648,72.6393085374419,73.2106963277099,72.220311888157,0.0
Punjab,11.0,Bathinda,1525289,626895,549533,0,1176428,0,549,1176977,77.1641964244153,77.5917766170755,77.3027666961136,0.0
Punjab,12.0,Sangrur,1424729,583555,516181,0,1099736,0,320,1100056,77.2115960298415,77.452806022566,77.6196856302057,0.0
Punjab,13.0,Patiala,1580273,593609,527264,0,1120873,0,117,1120990,70.9364774314312,71.565199779135,70.8482483580036,0.0
Rajasthan,1.0,Ganganagar,1718413,678212,573241,0,1251453,0,5908,1257361,73.1698957119156,74.5872315341581,70.8997765060487,0.0
Rajasthan,2.0,Bikaner,1592355,526374,402281,0,928655,0,2111,930766,58.4521667592968,62.1405550898981,54.0442396437184,0.0
Rajasthan,3.0,Churu,1753825,598297,529280,1,1127578,0,4352,1131930,64.5406468718373,64.7178383289885,64.2135274491962,100.0
Rajasthan,4.0,Jhunjhunu,1697470,521812,479727,0,1001539,0,7102,1008641,59.4202548498648,59.6744625933893,60.3574439174142,0.0
Rajasthan,5.0,Sikar,1769882,552960,507618,0,1060578,0,6884,1067462,60.3126084111822,58.9947338323532,61.6401827282464,0.0
Rajasthan,6.0,Jaipur Rural,1700306,556476,452621,0,1009097,0,7133,1016230,59.767477148231,61.5356374714563,57.1159427605179,0.0
Rajasthan,7.0,Jaipur,1957816,714851,578288,0,1293139,1,5812,1298951,66.3469396511215,68.2819917662454,63.5452688395358,0.0
Rajasthan,8.0,Alwar,1626442,585823,473846,0,1059669,0,3374,1063043,65.3600312830092,67.8657982780512,62.8157217605254,0.0
Rajasthan,9.0,Bharatpur,1690705,547046,413081,0,960127,0,3548,963675,56.9984119050929,60.3264855112819,53.0918321444637,0.0
Rajasthan,10.0,Karauli-Dholpur,1549468,491202,353973,0,845175,0,1168,846343,54.6215217093867,58.3062991200675,50.3929956934904,0.0
Rajasthan,11.0,Dausa,1524100,518917,409839,0,928756,0,2165,930921,61.0800472409947,63.7838867685651,57.8149223917696,0.0
Rajasthan,12.0,Tonk-Sawai Madhopur,1710775,583732,459375,0,1043107,0,818,1043925,61.0205900834417,64.158711840189,57.452324732108,0.0
Rajasthan,13.0,Ajmer,1683261,613187,540384,0,1153571,0,3296,1156867,68.7277255280078,70.6951374733677,66.4873603834825,0.0
Rajasthan,14.0,Nagaur,1678660,531452,469913,0,1001365,0,4158,1005523,59.9003371736981,60.2507519270078,59.5038988600994,0.0
Rajasthan,15.0,Pali,1902094,578674,512314,0,1090988,0,6265,1097253,57.6865812099717,58.1062165500206,56.7754047201092,0.0
Rajasthan,16.0,Jodhpur,1727791,596225,475258,0,1071483,0,8315,1079798,62.4958690026745,65.7648734117875,58.277039662054,0.0
Rajasthan,17.0,Barmer,1680152,653991,562013,0,1216004,0,3170,1219174,72.5633157000081,73.0037551683798,71.7905450717953,0.0
Rajasthan,18.0,Jalore,1824968,581247,506374,0,1087621,0,424,1088045,59.6199495004844,60.2983343568974,58.8214658262726,0.0
Rajasthan,19.0,Udaipur,1817940,599307,589859,0,1189166,0,4649,1193815,65.6685589183362,64.4530481214409,66.4388059331646,0.0
Rajasthan,20.0,Banswara,1698244,578240,590772,0,1169012,0,2476,1171488,68.9823134955872,66.7412288447133,71.0246891019784,0.0
Rajasthan,21.0,Chittorgarh,1819506,630617,539259,0,1169876,0,3121,1172997,64.4678830407814,67.8829508157898,60.5789872777825,0.0
Rajasthan,22.0,Rajsamand,1701194,506425,471078,0,977503,0,5529,983032,57.7848264219131,57.6924610475495,57.499234080781,0.0
Rajasthan,23.0,Bhilwara,1754901,580533,521628,0,1102161,0,1995,1104156,62.9184210391355,64.2683018633981,61.3342300944892,0.0
Rajasthan,24.0,Kota,1744539,632156,518136,0,1150292,0,5680,1155972,66.2623191570954,69.2451945616503,62.353378654026,0.0
Rajasthan,25.0,Jhalawar-Baran,1669844,635617,510625,0,1146242,0,165,1146407,68.6535388934535,73.1661469430698,63.7692978227585,0.0
Sikkim,1.0,Sikkim,370769,153370,146197,0,299567,0,10528,310095,83.6356329682363,80.5447021258718,81.3787920957417,0.0
Tamil Nadu,1.0,Thiruvallur ,1702833,644387,609702,23,1254112,0,328,1254440,73.6678229750069,75.6078730456719,71.7653608795907,8.77862595419847
Tamil Nadu,2.0,Chennai North,1422384,463981,445554,4,909539,0,913,910452,64.0088752404414,65.5865643813619,62.3759631753427,1.51515151515152
Tamil Nadu,3.0,Chennai South,1795743,556403,527433,11,1083847,0,1555,1085402,60.4430589455173,61.7573672234863,58.987676440293,3.51437699680511
Tamil Nadu,4.0,Chennai Central,1328018,421903,392161,15,814079,0,1150,815229,61.3868938523424,63.4401488028558,59.2051052497294,5.95238095238095
Tamil Nadu,5.0,Sriperumbudur,1946503,665892,620230,5,1286127,0,524,1286651,66.10064305064,67.7751981931825,64.3923820914365,1.89393939393939
Tamil Nadu,6.0,Kancheepuram ,1480123,572957,554099,0,1127056,0,2793,1129849,76.3348046074549,77.7620492719949,74.5885574135048,0.0
Tamil Nadu,7.0,Arakkonam,1401813,543169,543863,10,1087042,0,2729,1089771,77.7401122688975,78.8816808914487,76.9192582776212,23.8095238095238
Tamil Nadu,8.0,Vellore,1312257,483341,490341,5,973687,0,1516,975203,74.31493983267,74.6704382364255,74.4580113492279,25.0
Tamil Nadu,9.0,Krishnagiri,1379957,546295,522804,18,1069117,0,226,1069343,77.4910377642202,77.7524594083757,77.635779900981,14.2857142857143
Tamil Nadu,10.0,Dharmapuri,1358273,567657,533724,35,1101416,0,1287,1102703,81.1841949298852,81.60458526866,80.6914631454498,45.4545454545455
Tamil Nadu,11.0,Tiruvannamalai,1352966,527265,536809,2,1064076,0,4480,1068556,78.9787769980916,78.3660784485667,79.2842383863388,8.69565217391304
Tamil Nadu,12.0,Arani,1369668,546222,546279,1,1092502,0,4047,1096549,80.0594742667566,80.2623187852107,79.7732151462492,3.125
Tamil Nadu,13.0,Viluppuram,1387007,535359,528788,11,1064158,0,3964,1068122,77.0091282884658,77.1782096859295,76.4854098744789,8.27067669172932
Tamil Nadu,14.0,Kallakurichi,1412497,541221,562429,12,1103662,0,3844,1107506,78.4076709543454,76.5766798251199,79.7827083017118,9.02255639097744
Tamil Nadu,15.0,Salem,1498350,593293,555869,12,1149174,0,1588,1150762,76.8019488103581,78.1233581457697,75.3242688029833,10.3448275862069
Tamil Nadu,16.0,Namakkal,1329550,532212,526436,28,1058676,0,1348,1060024,79.7280282802452,80.5397037258988,78.7823099117651,39.4366197183099
Tamil Nadu,17.0,Erode,1321395,510564,495852,13,1006429,0,3029,1009458,76.3933570204216,77.7720232509962,74.6093126972997,19.1176470588235
Tamil Nadu,18.0,Tiruppur,1375589,543168,505372,4,1048544,0,2178,1050722,76.3834255726093,77.8680780848371,74.5704289881675,6.89655172413793
Tamil Nadu,19.0,Nilgiris ,1269173,472256,458764,4,931024,0,2469,933493,73.5512810310336,75.1991617927826,71.7976487085425,12.1212121212121
Tamil Nadu,20.0,Coimbatore,1720219,608444,565861,7,1174312,0,2315,1176627,68.3998374625556,70.0410730566274,66.4955298386793,11.4754098360656
Tamil Nadu,21.0,Pollachi,1381505,513435,496880,6,1010321,0,2431,1012752,73.3078780026131,74.7975403280437,71.555608679185,15.7894736842105
Tamil Nadu,22.0,Dindigul,1400531,538102,544003,24,1082129,0,1560,1083689,77.3770091486729,77.4423538012958,77.288413479366,22.4299065420561
Tamil Nadu,23.0,Karur,1298322,510504,533334,19,1043857,0,3197,1047054,80.6467116786129,79.6455372326318,81.2587987933083,61.2903225806452
Tamil Nadu,24.0,Tiruchirappalli,1387140,490711,494904,40,985655,0,3153,988808,71.2839367331344,71.2495027021062,70.9462481507391,48.1927710843374
Tamil Nadu,25.0,Perambalur,1285576,498647,528957,18,1027622,0,4044,1031666,80.2493201491005,78.7234613587279,81.2745937092346,69.2307692307692
Tamil Nadu,26.0,Cuddalore ,1247907,485201,497002,5,982208,0,2919,985127,78.9423410558639,77.5750647523423,79.8851073542223,13.1578947368421
Tamil Nadu,27.0,Chidambaram ,1366189,530346,556097,1,1086444,0,2398,1088842,79.6992217035857,77.3065317843243,81.8990490469114,4.76190476190476
Tamil Nadu,28.0,Mayiladuthurai,1350316,503104,520845,1,1023950,0,2631,1026581,76.0252414990269,74.0311720111127,77.7135857215116,100.0
Tamil Nadu,29.0,Nagapattinam ,1210617,452899,486855,2,939756,0,2812,942568,77.8584804277488,74.753448420997,80.5969926878246,28.5714285714286
Tamil Nadu,30.0,Thanjavur,1340050,480904,528697,3,1009604,0,3062,1012666,75.5692698033655,72.6678191071407,78.0789832395799,21.4285714285714
Tamil Nadu,31.0,Sivaganga,1412367,474734,551559,0,1026293,0,1180,1027473,72.7483012559767,67.5358780884746,77.9752909093222,0.0
Tamil Nadu,32.0,Madurai,1441434,483389,490525,26,973940,0,2445,976385,67.7370590675674,67.5105443982012,67.7783780721523,49.0566037735849
Tamil Nadu,33.0,Theni ,1441302,528940,546154,13,1075107,0,1583,1076690,74.7025952923121,74.0402718384087,76.0074761360679,12.8712871287129
Tamil Nadu,34.0,Virudhunagar,1350490,496203,512880,36,1009119,0,2594,1011713,74.9145125102741,74.4562118492999,75.4552650085183,40.9090909090909
Tamil Nadu,35.0,Ramanathapuram,1455988,465142,534167,14,999323,0,1925,1001248,68.7675997329648,63.6749925392953,73.7693756697933,17.5
Tamil Nadu,36.0,Thoothukkudi,1310406,448396,466414,1,914811,0,2102,916913,69.9716729013756,69.033810549458,70.8220209787237,50.0
Tamil Nadu,37.0,Tenkasi ,1382081,489624,525986,3,1015613,0,3823,1019436,73.7609445466655,71.24933425301,75.9557538737022,7.69230769230769
Tamil Nadu,38.0,Tirunelveli,1420435,468701,492310,2,961013,0,1634,962647,67.7712813328311,66.4792995505175,68.8996434029547,10.0
Tamil Nadu,39.0,Kanniyakumari,1467768,488828,501284,2,990114,0,1048,991162,67.5285194935439,66.1178800207756,69.3296673508113,2.85714285714286
Tripura,1.0,Tripura West,1248546,543278,523020,0,1066298,0,9634,1075932,86.174798525645,85.5957598999215,85.4479391986825,0.0
Tripura,2.0,Tripura East,1140276,486129,459313,0,945442,0,7333,952775,83.5565249115127,83.7435852381666,82.2746422865004,0.0
Uttar Pradesh,1.0,Saharanpur,1608833,652595,540479,12,1193086,0,1563,1194649,74.2556250400135,74.8176835231305,73.5326569789352,19.047619047619
Uttar Pradesh,2.0,Kairana,1531767,617921,500278,0,1118199,0,1548,1119747,73.1016531887683,73.644610980409,72.4625757718408,0.0
Uttar Pradesh,3.0,Muzaffarnagar,1588475,618042,484660,11,1102713,0,5052,1107765,69.7376414485592,70.8080853213816,68.0476695926631,14.4736842105263
Uttar Pradesh,4.0,Bijnor,1562081,575976,482184,10,1058170,0,2240,1060410,67.8844438924742,68.0051005950694,67.6257822383166,13.1578947368421
Uttar Pradesh,5.0,Nagina,1493419,484049,458292,8,942349,0,276,942625,63.1185889559461,60.8826844030328,65.698541217487,8.69565217391304
Uttar Pradesh,6.0,Moradabad,1771985,626722,499370,0,1126092,0,1984,1128076,63.6617127120151,65.1798649439901,61.6599043312697,0.0
Uttar Pradesh,7.0,Rampur,1616972,528149,430146,8,958303,0,33,958336,59.2673218831248,60.6078584379518,57.7977657324522,2.20385674931129
Uttar Pradesh,8.0,Sambhal,1693229,599491,456319,7,1055817,0,1287,1057104,62.4312482245461,64.3645741513573,59.9314947051554,6.36363636363636
Uttar Pradesh,9.0,Amroha,1544245,589753,505978,0,1095731,0,164,1095895,70.9663945811707,71.2115010064347,70.8434375962589,0.0
Uttar Pradesh,10.0,Meerut,1764387,631761,479781,0,1111542,0,2129,1113671,63.1194290141562,65.1244274974409,60.6227279791666,0.0
Uttar Pradesh,11.0,Baghpat,1505175,582431,421180,0,1003611,0,1155,1004766,66.7540983606557,68.8462484101429,64.5654806616283,0.0
Uttar Pradesh,12.0,Ghaziabad,2357553,781962,559856,0,1341818,0,653,1342471,56.9434069986974,58.7169644707557,54.6839577535913,0.0
Uttar Pradesh,13.0,Gautam Buddha Nagar,1986109,707052,491342,0,1198394,0,971,1199365,60.3876725799037,64.0541965549168,55.8776233399066,0.0
Uttar Pradesh,14.0,Bulandshahr,1736436,549613,459467,15,1009095,0,1103,1010198,58.1765178791502,59.2543997723029,57.1546745183798,13.6363636363636
Uttar Pradesh,15.0,Aligarh,1793126,596880,467715,2,1064597,0,100,1064697,59.376585917554,61.9327526186635,56.6276569469264,1.65289256198347
Uttar Pradesh,16.0,Hathras,1758927,596865,452373,2,1049240,0,49,1049289,59.6550624329492,61.7034627917363,57.4100724902534,2.12765957446809
Uttar Pradesh,17.0,Mathura,1682260,619776,457879,1,1077656,0,675,1078331,64.1001390985936,66.8567378732521,61.1754127425451,0.574712643678161
Uttar Pradesh,18.0,Agra,1814739,621497,448004,2,1069503,0,902,1070405,58.9839640851935,61.97740282016,55.2661510183438,3.03030303030303
Uttar Pradesh,19.0,Fatehpur Sikri,1580582,565514,401637,1,967152,0,1081,968233,61.2580049627289,64.5906788420794,57.171550094518,2.27272727272727
Uttar Pradesh,20.0,Firozabad,1636738,643026,461542,0,1104568,0,79,1104647,67.4907651682798,71.3957697218675,62.9509654558176,0.0
Uttar Pradesh,21.0,Mainpuri,1653058,579581,418952,5,998538,0,889,999427,60.4592821304516,64.619533890132,55.8428436994324,17.2413793103448
Uttar Pradesh,22.0,Etah,1577457,520186,405831,0,926017,0,266,926283,58.7200158229353,60.8275197560285,56.4048217018278,0.0
Uttar Pradesh,23.0,Badaun,1769145,595106,431771,7,1026884,0,785,1027669,58.0884551577174,60.9050204430435,54.6150129273488,11.4754098360656
Uttar Pradesh,24.0,Aonla,1653577,572213,422483,4,994700,0,1117,995817,60.2219914766594,62.4662813102119,57.4032834640641,10.8108108108108
Uttar Pradesh,25.0,Bareilly,1664081,574826,441899,3,1016728,0,1372,1018100,61.180916073196,63.136470975891,58.7330173607696,6.81818181818182
Uttar Pradesh,26.0,Pilibhit,1671154,586095,464229,18,1050342,0,226,1050568,62.8648227512246,64.9463835936124,60.4974503259908,33.9622641509434
Uttar Pradesh,27.0,Shahjahanpur,1979294,663380,464707,0,1128087,0,2482,1130569,57.1198114075019,60.349846801016,52.882129364104,0.0
Uttar Pradesh,28.0,Kheri,1679466,606219,471614,15,1077848,0,33,1077881,64.1799833994853,67.0298163869607,60.9020624214695,24.5901639344262
Uttar Pradesh,29.0,Dhaurahra,1558041,605084,454769,14,1059867,0,407,1060274,68.0517393316351,71.4815296105093,63.95855630579,15.2173913043478
Uttar Pradesh,30.0,Sitapur,1550263,581709,444625,0,1026334,0,653,1026987,66.2459853586134,69.4272844887261,62.4512785218167,0.0
Uttar Pradesh,31.0,Hardoi,1714388,565516,407349,0,972865,0,41,972906,56.7494639486511,60.2161116932015,52.6067085179555,0.0
Uttar Pradesh,32.0,Misrikh,1725589,574416,423674,0,998090,0,224,998314,57.8535213193872,60.6177903615755,54.5233897432598,0.0
Uttar Pradesh,33.0,Unnao,2164392,673666,526266,4,1199936,0,1870,1201806,55.5262632646951,56.4728230208156,54.2995137181422,5.06329113924051
Uttar Pradesh,34.0,Mohanlalganj,1838194,637851,476997,0,1114848,0,1810,1116658,60.7475598331841,64.1543080427862,56.6258609677978,0.0
Uttar Pradesh,35.0,Lucknow,1949956,580513,450547,0,1031060,0,3638,1034698,53.0626332081339,55.2303018713187,50.2221023309319,0.0
Uttar Pradesh,36.0,Rae Bareli,1594954,437762,387368,0,825130,0,12,825142,51.7345327827636,51.0834291182151,52.590506860139,0.0
Uttar Pradesh,37.0,Amethi,1669843,461524,413341,0,874865,0,7,874872,52.3924704298548,51.8763888717163,53.0798815998151,0.0
Uttar Pradesh,38.0,Sultanpur,1703698,499563,465648,0,965211,0,99,965310,56.6596896867872,54.9663146845529,58.7244636080798,0.0
Uttar Pradesh,39.0,Pratapgarh,1716394,454891,437808,33,892732,0,1792,894524,52.1164720920721,49.3066153899516,55.246979012084,25.1908396946565
Uttar Pradesh,40.0,Farrukhabad,1613781,560618,409931,0,970549,0,200,970749,60.1537011527586,62.9831436185272,56.8491925362475,0.0
Uttar Pradesh,41.0,Etawah,1707237,529547,408334,0,937881,0,2012,939893,55.0534577214528,56.544000034169,53.1702203847781,0.0
Uttar Pradesh,42.0,Kannauj,1808886,629125,484744,0,1113869,0,707,1114576,61.6167077416708,63.0258204251244,59.999678182374,0.0
Uttar Pradesh,43.0,Kanpur,1611248,485562,349156,0,834718,0,407,835125,51.8309409848763,54.6247963784616,48.3857601554304,0.0
Uttar Pradesh,44.0,Akbarpur,1768635,559566,411414,0,970980,0,468,971448,54.9264263118168,57.309798973359,52.0556472888079,0.0
Uttar Pradesh,45.0,Jalaun,1887189,632802,476033,11,1108846,0,351,1109197,58.7750882397047,61.0124290255494,56.0377687213209,45.8333333333333
Uttar Pradesh,46.0,Jhansi,1932052,734228,586213,0,1320441,0,426,1320867,68.3660170637229,71.0158594748199,65.2919863716304,0.0
Uttar Pradesh,47.0,Hamirpur,1737993,550111,427480,2,977593,0,337,977930,56.2677755318923,58.0131040977461,54.2469410907762,6.89655172413793
Uttar Pradesh,48.0,Banda,1601855,473933,384301,0,858234,0,455,858689,53.6059131444482,53.5877187626497,53.6128224015357,0.0
Uttar Pradesh,49.0,Fatehpur,1804753,574629,481306,5,1055940,0,1252,1057192,58.5782098713785,58.3557428658475,58.8148461338244,14.7058823529412
Uttar Pradesh,50.0,Kaushambi,1738509,491070,418758,0,909828,0,686,910514,52.3732692784449,51.4811564940354,53.4797917297237,0.0
Uttar Pradesh,51.0,Phulpur,1913275,541264,418152,4,959420,0,999,960419,50.1976453985967,50.9015812231863,49.2563580036045,2.17391304347826
Uttar Pradesh,52.0,Allahabad,1666569,506755,384075,3,890833,0,802,891635,53.5012351723811,55.2530493821642,51.2869303955934,1.81818181818182
Uttar Pradesh,53.0,Barabanki,1721278,611146,457015,0,1068161,0,8,1068169,62.0567392367764,66.0310044687233,57.481463779691,0.0
Uttar Pradesh,54.0,Faizabad,1738701,558076,464473,9,1022558,0,176,1022734,58.8217295555705,59.6971051916572,57.9128227315744,14.7540983606557
Uttar Pradesh,55.0,Ambedkar Nagar,1718774,541195,493159,1,1034355,0,80,1034435,60.1844686968735,58.6639625206225,62.0591977187699,1.26582278481013
Uttar Pradesh,56.0,Bahraich,1638640,522529,411550,2,934081,0,249,934330,57.0186252013865,59.2086760541675,54.4470492358495,2.0
Uttar Pradesh,57.0,Kaiserganj,1711967,527027,415386,0,942413,0,1024,943437,55.108363654206,56.807802211187,53.023419679066,0.0
Uttar Pradesh,58.0,Shrawasti,1788080,559351,420598,2,979951,0,245,980196,54.818352646414,57.2898913506604,51.8245252168299,3.84615384615385
Uttar Pradesh,59.0,Gonda,1710825,487483,384938,1,872422,0,1512,873934,51.0826063448921,52.1442461764901,49.6389954543989,2.0
Uttar Pradesh,60.0,Domariyaganj,1761415,490089,444938,0,935027,0,2,935029,53.083969422311,50.9503106364929,55.66762920443,0.0
Uttar Pradesh,61.0,Basti,1787476,549704,498809,8,1048521,0,18,1048539,58.6603120825119,57.1414909485917,60.4927865957777,5.83941605839416
Uttar Pradesh,62.0,Sant Kabir Nagar,1904315,521201,490916,0,1012117,0,16,1012133,53.1494526903375,49.8901117835011,57.1802627946714,0.0
Uttar Pradesh,63.0,Maharajganj,1743131,549757,510481,0,1060238,0,3,1060241,60.8239426640912,58.1189470112071,64.0774078876514,0.0
Uttar Pradesh,64.0,Gorakhpur,1903988,582909,457008,17,1039934,0,888,1040822,54.6653655380181,55.2788127709251,53.8793006895722,10.7594936708861
Uttar Pradesh,65.0,Kushi Nagar,1680992,505771,444293,0,950064,0,728,950792,56.5613637661571,54.3506083899025,59.2222475483629,0.0
Uttar Pradesh,66.0,Deoria,1806926,508083,462357,3,970443,0,1717,972160,53.8018712443122,50.9604679573206,57.1372608143311,1.02389078498294
Uttar Pradesh,67.0,Bansgaon,1760090,459714,417437,1,877152,0,759,877911,49.878756199967,46.9348312817199,53.559450339368,1.0752688172043
Uttar Pradesh,68.0,Lalganj,1661470,456872,441988,0,898860,0,688,899548,54.1416938012724,50.4518750828217,58.6061954529905,0.0
Uttar Pradesh,69.0,Azamgarh,1703121,504375,455380,0,959755,0,845,960600,56.4023343027301,53.6955871409515,59.8637559912396,0.0
Uttar Pradesh,70.0,Ghosi,1891112,547380,492131,0,1039511,0,319,1039830,54.9851092901954,52.7253672801809,57.9030781648198,0.0
Uttar Pradesh,71.0,Salempur,1661737,450187,404269,1,854457,0,1319,855776,51.4988833973126,49.8696174262901,53.4721184280664,0.8
Uttar Pradesh,72.0,Ballia,1768271,517773,423406,3,941182,0,1093,942275,53.2879292823329,53.4002951711363,53.398661899447,5.26315789473684
Uttar Pradesh,73.0,Jaunpur,1848842,527140,479177,0,1006317,0,918,1007235,54.4792361921679,52.5722127422342,56.6606006643041,0.0
Uttar Pradesh,74.0,Machhlishahr,1891969,512798,483995,0,996793,0,1120,997913,52.744680277531,49.9750026556633,55.9692905819132,0.0
Uttar Pradesh,75.0,Ghazipur,1801519,528986,457272,1,986259,0,456,986715,54.7712791261152,54.0041183058388,56.0127687044248,1.61290322580645
Uttar Pradesh,76.0,Chandauli,1593133,545894,433978,1,979873,0,781,980654,61.5550616301338,61.6044183233122,61.617994502374,0.847457627118644
Uttar Pradesh,77.0,Varanasi,1766487,593071,436735,10,1029816,0,996,1030812,58.3537835262869,60.2100704261814,55.9296421276405,10.8695652173913
Uttar Pradesh,78.0,Bhadohi,1834598,527390,454368,2,981760,0,394,982154,53.5351068735494,51.9309032150703,55.5294428210553,1.28205128205128
Uttar Pradesh,79.0,Mirzapur,1720661,557612,449962,7,1007581,0,65,1007646,58.5615644220448,59.4488096634221,57.5518201980461,5.42635658914729
Uttar Pradesh,80.0,Robertsganj,1639074,498085,387542,1,885628,0,248,885876,54.047346245502,55.2858333694073,52.5281961129281,2.38095238095238
West Bengal,1.0,Cooch Behar,1613403,687125,642008,0,1329133,0,3835,1332968,82.6184158576623,81.0749742188366,84.0003558849236,0.0
West Bengal,2.0,Alipurduars,1470911,619392,603041,0,1222433,0,2804,1225237,83.2978337914395,82.1000058321713,84.3888451968799,0.0
West Bengal,3.0,Jalpaiguri,1531468,675989,625242,0,1301231,0,3049,1304280,85.1653446235899,85.0934280621545,85.0399805231811,0.0
West Bengal,4.0,Darjeeling,1437154,587016,553877,14,1140907,0,1789,1142696,79.5110336122642,80.7644205964297,79.5823155837811,46.6666666666667
West Bengal,5.0,Raiganj,1387526,563566,543020,0,1106586,0,1917,1108503,79.8906110588198,77.8920336907516,81.8714861012063,0.0
West Bengal,6.0,Balurghat,1254497,548053,513027,0,1061080,0,2324,1063404,84.7673609422741,83.9062545451205,85.4532280631621,0.0
West Bengal,7.0,Maldaha Uttar,1425428,578561,582591,0,1161152,0,2004,1163156,81.6004736822905,78.2032583733545,85.1430032882718,0.0
West Bengal,8.0,Maldaha Dakshin,1347143,545088,544292,0,1089380,0,3085,1092465,81.0949542847344,78.8319141058867,83.1885701534648,0.0
West Bengal,9.0,Jangipur,1391656,559290,559068,0,1118358,0,962,1119320,80.4307961162816,78.3376380352631,82.657736577144,0.0
West Bengal,10.0,Baharampur,1453783,584203,569867,0,1154070,0,632,1154702,79.4273973488478,77.9982509896595,81.5174073131028,0.0
West Bengal,11.0,Murshidabad,1512098,653122,635049,0,1288171,0,407,1288578,85.2178893166977,83.585493395036,87.0676772136106,0.0
West Bengal,12.0,Krish0agar,1476783,638727,607902,0,1246629,0,2066,1248695,84.5550768122331,83.3085952784662,86.1789493829698,0.0
West Bengal,13.0,Ranaghat,1602849,691141,658049,0,1349190,0,4433,1353623,84.4510618280325,83.4209617886826,85.45125420894,0.0
West Bengal,14.0,Bangaon,1540713,653011,627517,0,1280528,0,3769,1284297,83.3573157362857,82.3615548287905,84.5312649441166,0.0
West Bengal,15.0,Barrackpore,1287222,567286,481436,0,1048722,0,3878,1052600,81.7729964217517,83.3759801291897,79.7225980271209,0.0
West Bengal,16.0,Dum Dum,1405981,590114,539290,0,1129404,0,4397,1133801,80.6412746687189,82.5662221078023,78.168506769753,0.0
West Bengal,17.0,Barasat,1512792,669359,596363,24,1265746,0,4418,1270164,83.961575682579,86.6413483431125,80.8589422874847,100.0
West Bengal,18.0,Basirhat,1490596,677047,595849,1,1272897,0,1188,1274085,85.4748704545028,87.1839479353519,83.6584578232057,6.25
West Bengal,19.0,Joynagar,1458724,633029,555516,0,1188545,0,608,1189153,81.5200819346223,83.5474496098658,79.2808272940827,0.0
West Bengal,20.0,Mathurapur,1488785,662025,607691,0,1269716,0,1492,1271208,85.3855996668424,85.7790896098495,84.832050433729,0.0
West Bengal,21.0,Diamond Harbour,1555914,682840,577412,0,1260252,0,1076,1261328,81.066691346694,83.7002461339322,78.0910159329951,0.0
West Bengal,22.0,Jadavpur,1595744,666829,605165,0,1271994,0,2729,1274723,79.8826754166082,82.2189013872295,77.1838016878875,0.0
West Bengal,23.0,Kolkata Dakshin,1685296,626618,540007,0,1166625,0,1842,1168467,69.3330429788002,70.42503309859,67.945151358445,0.0
West Bengal,24.0,Kolkata Uttar,1433985,534806,419974,3,954783,0,1365,956148,66.6776849130221,67.0762940387051,65.9850927305065,50.0
West Bengal,25.0,Howrah,1505099,621808,503224,3,1125035,0,693,1125728,74.7942826352287,77.5144823562703,71.6587089231628,60.0
West Bengal,26.0,Uluberia,1448632,629091,557334,0,1186425,0,749,1187174,81.9513858592106,82.617940077169,81.1852054706721,0.0
West Bengal,27.0,Srerampur,1624038,680999,608386,2,1289387,0,1767,1291154,79.5026963654791,80.4031023128028,78.4261302697797,14.2857142857143
West Bengal,28.0,Hooghly,1630042,696614,650941,1,1347556,0,3383,1350939,82.8775577561805,83.3985607273224,82.0990246861729,7.69230769230769
West Bengal,29.0,Arambagh,1600293,707257,654127,0,1361384,0,1464,1362848,85.1624046346513,84.9737602183765,85.3832428107301,0.0
West Bengal,30.0,Tamluk,1527273,684160,650897,1,1335058,0,3278,1338336,87.6291272090844,86.0961988105395,89.1992857446304,8.33333333333333
West Bengal,31.0,Kanthi,1490409,663897,626338,0,1290235,0,2138,1292373,86.7126406241508,85.7163330441249,87.9832781510445,0.0
West Bengal,32.0,Ghatal,1610489,690945,675066,8,1366019,0,1618,1367637,84.9206048597662,82.8619261714623,87.22594349862,57.1428571428571
West Bengal,33.0,Jhargram,1475112,645909,610427,0,1256336,0,1309,1257645,85.2575939996421,85.7957481287649,84.6826137802927,0.0
West Bengal,34.0,Medinipur,1499673,647452,613326,0,1260778,0,2317,1263095,84.2246943166944,84.1622795044782,84.1446298849629,0.0
West Bengal,35.0,Purulia,1471933,627261,574047,1,1201309,0,5344,1206653,81.9774405492641,82.076978939724,81.1931588341956,16.6666666666667
West Bengal,36.0,Bankura,1503812,644501,590353,0,1234854,0,1759,1236613,82.2318880285568,83.2669266089419,81.1843350165572,0.0
West Bengal,37.0,Bishnupur,1466921,667023,603708,0,1270731,0,1368,1272099,86.7189848669424,88.0963135539495,85.4199416203398,0.0
West Bengal,38.0,Bardhaman Purba,1532244,682635,637516,1,1320152,0,988,1321140,86.2225598533915,85.9674685352025,86.627613880181,16.6666666666667
West Bengal,39.0,Burdwan - Durgapur,1583495,700025,629761,3,1329789,0,1943,1331732,84.1008023391296,85.3534971736809,82.6995226557935,42.8571428571429
West Bengal,40.0,Asansol,1469684,633286,509230,2,1142518,0,268,1142786,77.7572593836498,80.0312903609007,75.1599933877272,14.2857142857143
West Bengal,41.0,Bolpur,1538420,682036,621426,0,1303462,1,1600,1305062,84.831320445652,85.6236449392443,84.0591825471545,0.0
West Bengal,42.0,Birbhum,1495087,669860,605076,0,1274936,0,1012,1275948,85.3427258748153,86.7102379593205,83.8859405413499,0.0
Chhattisgarh,1.0,Sarguja,1523022,610812,576493,0,1187305,0,24,1187329,77.9587556844222,79.22807327026,76.6781275146808,0.0
Chhattisgarh,2.0,Raigarh,1626949,631470,614665,0,1246135,0,84,1246219,76.5985289028728,77.1810645015015,76.1254438426775,0.0
Chhattisgarh,3.0,Janjgir-Champa,1744201,558932,514393,0,1073325,0,42,1073367,61.5391804040933,62.4139609882036,60.6619125508422,0.0
Chhattisgarh,4.0,Korba,1423729,545187,506882,0,1052069,0,770,1052839,73.9493962685314,74.7137526192235,73.0788195095226,0.0
Chhattisgarh,5.0,Bilaspur,1729229,573078,516910,0,1089988,0,595,1090583,63.0675867684384,64.3263878521615,61.7040934723131,0.0
Chhattisgarh,6.0,Raj0dgaon,1591373,603428,574874,0,1178302,0,3,1178305,74.0432946895542,75.6913381718016,72.4170422680698,0.0
Chhattisgarh,7.0,Durg,1858922,661165,597929,0,1259094,0,48,1259142,67.7350636551722,69.7374791288049,65.7443406972806,0.0
Chhattisgarh,8.0,Raipur,1904460,659154,591606,0,1250760,0,112,1250872,65.6811904686893,67.32195766142,63.9952490824304,0.0
Chhattisgarh,9.0,Mahasamund,1516177,576664,554172,0,1130836,0,418,1131254,74.6122649268522,76.1338941742779,73.0739004077155,0.0
Chhattisgarh,10.0,Bastar,1298083,386189,383710,0,769899,0,73,769972,59.3160837943336,61.0335219810699,57.6801951785604,0.0
Chhattisgarh,11.0,Kanker,1448375,515715,500911,0,1016626,0,454,1017080,70.2221455078968,71.4350025487024,69.0748802696192,0.0
Jharkhand,1.0,Rajmahal,1353467,490824,460471,0,951295,0,460,951755,70.3197787607677,71.022130386088,69.5651188648916,0.0
Jharkhand,2.0,Dumka,1273049,466619,435895,0,902514,0,548,903062,70.9369395836295,70.9139872372178,70.932713227744,0.0
Jharkhand,3.0,Godda,1590771,549854,499254,0,1049108,0,534,1049642,65.9832244867426,65.4699550042448,66.5490986451685,0.0
Jharkhand,4.0,Chatra,1312562,383214,329747,0,712961,0,19,712980,54.3197197541907,55.0740425629764,53.5367015896364,0.0
Jharkhand,5.0,Kodarma,1639645,535308,489593,0,1024901,0,38,1024939,62.5098115750666,61.5495349647415,63.6215968261518,0.0
Jharkhand,6.0,Giridih,1511644,531982,439241,0,971223,0,19,971242,64.2507098232124,65.5671068767679,62.7488935682673,0.0
Jharkhand,7.0,Dhanbad,1890021,642557,501332,0,1143889,0,56,1143945,60.5255179704353,62.3444074992941,58.4450845959876,0.0
Jharkhand,8.0,Ranchi,1648459,562384,487221,0,1049605,0,182,1049787,63.6829305430102,64.8354511518304,62.4935546679596,0.0
Jharkhand,9.0,Jamshedpur,1581665,548089,501033,0,1049122,0,42,1049164,66.3328833855463,67.5882913667512,65.090692254328,0.0
Jharkhand,10.0,Singhbhum,1152632,403571,391653,0,795224,0,128,795352,69.0031163458936,69.2539224115001,68.818989783977,0.0
Jharkhand,11.0,Khunti,1111856,373314,364162,0,737476,0,135,737611,66.3405153185305,66.0960862598596,66.682780606873,0.0
Jharkhand,12.0,Lohardaga,1119144,333825,317508,0,651333,0,306,651639,58.2265552958333,57.8848804848233,58.8498708115702,0.0
Jharkhand,13.0,Palamau,1645957,523108,453494,0,976602,0,1557,978159,59.4279801963235,58.8276043552679,59.9977244222414,0.0
Jharkhand,14.0,Hazaribagh,1518923,515052,452228,0,967280,0,68,967348,63.6864409848294,63.443253583566,64.0393558509825,0.0
Uttarakhand,1.0,Tehri Garhwal,1352614,400041,370827,0,770868,0,6077,776945,57.4402601185556,56.8480692111149,58.150515444518,0.0
Uttarakhand,2.0,Garhwal,1267218,320955,357047,0,678002,0,6012,684014,53.9776107978264,51.3299684300423,59.0175938537217,0.0
Uttarakhand,3.0,Almora,1253541,316094,339409,1,655504,0,1430,656934,52.4062635366534,50.6562521033721,55.9723410957029,5.88235294117647
Uttarakhand,4.0,Nainital-Udhamsingh Nagar,1610811,589435,509910,0,1099345,0,2589,1101934,68.4086463278435,69.2235421229719,67.9319335108757,0.0
Uttarakhand,5.0,Hardwar,1642873,637480,535871,1,1173352,0,2382,1175734,71.5657266264647,72.0484904378764,71.1884423779475,2.5
Andaman & Nicobar Islands,1.0,Andaman & Nicobar Islands,269360,101129,89084,0,190213,0,133,190346,70.6660231660232,70.9612456407486,70.4627967127275,0.0
Chandigarh,1.0,Chandigarh,615205,244907,208415,0,453322,2,138,453460,73.7087637454182,73.5703900410949,74.1555803039306,0.0
Dadra & Nagar Haveli,1.0,Dadar & Nagar Haveli,196597,87792,77494,0,165286,0,38,165324,84.0928396669329,82.6736729101336,85.7367291394685,0.0
Daman & Diu,1.0,Daman & Diu,111818,42355,44873,0,87228,0,5,87233,78.0133788835429,74.3031068540252,81.8641223045207,0.0
NCT OF Delhi,1.0,Chandni Chowk                 ,1447228,548427,431342,21,979790,0,2485,982275,67.8728576285147,69.3168130497264,65.775312185013,36.2068965517241
NCT OF Delhi,2.0,North East Delhi              ,1957707,738979,574789,28,1313796,0,4178,1317974,67.3223316870196,68.4740689949129,65.4596785490177,23.728813559322
NCT OF Delhi,3.0,East Delhi                    ,1829572,676930,518463,35,1195428,0,1303,1196731,65.4104347902132,66.1666673183014,64.3287863635574,23.1788079470199
NCT OF Delhi,4.0,New Delhi                     ,1490147,545628,422884,7,968519,0,1650,970169,65.1055902538474,65.7568519317494,64.1295924758235,9.21052631578947
NCT OF Delhi,5.0,North West Delhi              ,2194343,757777,595362,42,1353181,0,3223,1356404,61.8136727029457,62.5286330089909,60.6679608088898,21.6494845360825
NCT OF Delhi,6.0,West Delhi                    ,2039410,742213,603424,8,1345645,0,3099,1348744,66.1340289593559,66.9870351400503,64.8873012408101,6.95652173913043
NCT OF Delhi,7.0,South Delhi                   ,1752748,639042,462222,13,1101277,0,1572,1102849,62.9211386919283,63.6007607703646,61.8683292598373,10.2362204724409
Lakshadweep,1.0,Lakshadweep,49922,21584,21655,0,43239,0,3,43242,86.6191258363046,85.170862599637,88.4635810286368,0.0
Puducherry,1.0,Puducherry,901292,351544,388189,17,739750,0,303,740053,82.1102373037817,81.4302127344155,82.7444569021746,85.0
